!SIL	SIL
<UNK>	SPN
§	s E k S @ n
Á	A A k u t
À	A g R A v i s
ADHOCKOMITÉ	A d h O k k u m i t e
ADHOCKOMITÉANE	A d h O k k u m i t e a n a
ADHOCKOMITÉAR	A d h O k k u m i t e a R
ADHOCKOMITÉEN	A d h O k k u m i t e @ n
AFRICAS	A f R i k A s
AKSIALFJØR	A k s i A l f j y R
AKSIALFJØRA	A k s i A l f j y R A
AKSIALFJØRAS	A k s i A l f j y R a s
AKSIALFJØREN	A k s i A l f j y R @ n
AKSIALFJØRENE	A k s i A l f j y R E n a
AKSIALFJØRENES	A k s i A l f j y R e n @ s
AKSIALFJØRENS	A k s i A l f j y R @ n s
AKSIALFJØRER	A k s i A l f j y R @ R
AKSIALFJØRERS	A k s i A l f j y R a S
AKSIALFJØRS	A k s i A l f j W S
AKSJONSKOMITÉANE	A k S O n s k u m i t e a n a
AKSJONSKOMITÉAR	A k S O n s k u m i t e a R
ALLÉANE	A l l e a n a
ALLÉAR	A l l e a R
ALLVÊRSJAGAR	A l v a R S a g a R
ALLVÊRSJAGARANE	A l v a R S a g a R a n a
ALLVÊRSJAGARAR	A l v a R S a g a R a R
ALLVÊRSJAGAREN	A l v a R S a g a R @ n
ALSVÊR	A l s v @ R
ALSVÊRANE	A l s v e R a n a
ALSVÊRAR	A l s v e R a R
ALSVÊREN	A l s v e R @ n
AMENORÉANE	a m e n u R e a n a
AMENORÉAR	a m e n u R e a R
ANDFÓR	A n n f u R
ANDRÉ	A n n R e
APNÉ	A p n e
APNÉANE	A p n e a n a
APNÉAR	A p n e a R
APNÉEN	A p n e @ n
APOGÉ	a p u g e
APOGÉA	a p u g e A
APOGÉET	a p u g e @ t
APOGÉI	a p u g e i
APRILVÊR	A p R I l v @ R
APRILVÊRA	A p R I l v e R A
APRILVÊRET	A p R I l v e R @ t
APRILVÊRI	A p R I l v e R i
ARBEIDSMØTE	A R b aI d s m y t a
ARBEIDSMØTER	A R b aI d s m y t @ R
ARKÉ	A R k e
ARKÉANE	A R k e a n a
ARKÉAR	A R k e a R
ARKÉEN	A R k e @ n
ARMÉANE	A R m e a n a
ARMÉAR	A R m e a R
ARMÉGEVÆRI	A R m e g e v a R i
ARMÉGRUPPONE	A R m e g R u p u n a
ARMÉGRUPPOR	A R m e g R u p u R
ARMÉKORPSA	A R m e k O R p s A
ARMÉKORPSET	A R m e k O R p s @ t
ARMÉKORPSI	A R m e k O R p s i
ARRANGEMENTSKOMITÉ	A R R A N e m @ n t s k u m i t e
ARRANGEMENTSKOMITÉANE	A R R A N e m @ n t s k u m i t e a n a
ARRANGEMENTSKOMITÉAR	A R R A N e m @ n t s k u m i t e a R
ASVÊR	A s v @ R
ASVÊRA	A s v e R A
ASVÊRET	A s v e R @ t
ASVÊRI	A s v e R i
ATTACHÉANE	A t A S e a n a
ATTACHÉAR	A t A S e a R
AUGEFÓR	a w g e f u R
AUGNEFÓR	a w N n e f u R
AURFÒR	a w R f u R
AURFÒRA	a w R f u R A
AURFÒRENE	a w R f u R E n a
AURFÒRER	a w R f u R @ R
AURFÒRI	a w R f u R i
AUSTANVÊR	a w s t A n v @ R
AUSTANVÊRA	a w s t A n v e R A
AUSTANVÊRET	a w s t A n v e R @ t
AUSTAVÊR	a w s t a v @ R
AUSTAVÊRA	a w s t a v e R A
AUSTAVÊRET	a w s t a v e R @ t
AUSTAVÊRI	a w s t a v e R i
AUTODAFÉANE	a w t u d a f e a n a
AUTODAFÉAR	a w t u d a f e a R
AVHALDSKAFÉ	A v h A l l s k a f e
AVHALDSKAFÉANE	A v h A l l s k a f e a n a
AVHALDSKAFÉAR	A v h A l l s k a f e a R
AVHALDSKAFÉEN	A v h A l l s k a f e @ n
AVLSVÊR	A v l s v @ R
AVLSVÊRANE	A v l s v e R a n a
AVLSVÊRAR	A v l s v e R a R
AVLSVÊREN	A v l s v e R @ n
AVLØS	A v l y s
AVLØSE	A v l y s a
AVLØSENDE	A v l y s E n n a
AVLØSENDES	A v l y s E n n @ s
AVLØSER	A v l y s @ R
AVLØSES	A v l y s @ s
AVLØSING	A v l y s I N
AVLØST	A v l W s t
AVLØSTE	A v l W s t a
AVLØSTES	A v l W s t @ s
AVLØSTS	A v l W s t s
AVSLØR	A v S l y R
AVSTØTT	A v s t W t
BADEVÊR	b a d e v @ R
BADEVÊRA	b a d e v e R A
BADEVÊRET	b a d e v e R @ t
BARRIÉRE	b A R R i e R a
BARRIÉREN	b A R R i e R @ n
BARRIÉRER	b A R R i e R @ R
BEARNÉSANE	b @ A R n e s a n a
BEARNÉSAR	b @ A R n e s a R
BEARNÉSSAUSANE	b @ A R n e s s a w s a n a
BEARNÉSSAUSAR	b @ A R n e s s a w s a R
BEHANDLINGSMØTER	b @ h A n n l I N s m y t @ R
BELØNT	b @ l W n t
BELØNTE	b @ l W n t a
BELØNTES	b @ l W n t @ s
BELØNTS	b @ l W n t s
BERGFLÒG	b @ R g f l u g
BERGFLÒGA	b @ R g f l u g A
BERGFLÒGET	b @ R g f l u g @ t
BERGFLÒGI	b @ R g f l u j i
BERGSTRØM	b @ R g s t R y m
BIDÉI	b i d e i
BIKKJEVÊR	b I k j e v @ R
BIKKJEVÊRA	b I k j e v e R A
BIKKJEVÊRET	b I k j e v e R @ t
BIKKJEVÊRI	b I k j e v e R i
BJØRKE	b j W R k a
BJØRKLUND	b j W R k l u n n
BJØRKMAN	b j W R k m a n
BJØRNEVÒK	b j W R n e v u k
BJØRNEVÒKA	b j W R n e v u k A
BJØRNEVÒKENE	b j W R n e v u k E n a
BJØRNEVÒKER	b j W R n e v u k @ R
BJØRNEVÒKI	b j W R n e v u dZ i
BJØRNÆS	b j W R n E s
BJØRNØ	b j W R n y
BLANDFÔRI	b l A n n f u R i
BLANKLÊR	b l A N k l @ R
BLANKLÊRA	b l A N k l e R A
BLANKLÊRET	b l A N k l e R @ t
BLANKLÊRI	b l A N k l e R i
BLAUTFÔR	b l a w t f u R
BLAUTFÔRA	b l a w t f u R A
BLAUTFÔRET	b l a w t f u R @ t
BLAUTFÔRI	b l a w t f u R i
BLAUTRÒTANE	b l a w t R u t a n a
BLAUTRÒTAR	b l a w t R u t a R
BLAUTRÒTE	b l a w t R u t a
BLAUTRÒTEN	b l a w t R u t @ n
BLAUTRÒTENT	b l a w t R u t E n t
BLAUTRÒTI	b l a w t R u t i
BLAUTRÒTNARE	b l a w t R O t n a R a
BLAUTRÒTNAST	b l a w t R O t n A s t
BLAUTRÒTNASTE	b l a w t R O t n A s t a
BLAUTRÒTNE	b l a w t R O t n a
BLEKKVISKELÊR	b l E k v I s k e l @ R
BLEKKVISKELÊRA	b l E k v I s k e l e R A
BLEKKVISKELÊRET	b l E k v I s k e l e R @ t
BLEKKVISKELÊRI	b l E k v I s k e l e R i
BLESTKOMITÉANE	b l E s t k u m i t e a n a
BLESTKOMITÉAR	b l E s t k u m i t e a R
BLÓT	b l u t
BLÒT	b l u t
BLÓTA	b l u t A
BLÒTA	b l u t A
BLÒTANDE	b l u t A n n a
BLÒTANE	b l u t a n a
BLÒTAR	b l u t a R
BLÒTAS	b l u t a s
BLÒTAST	b l u t A s t
BLÓTDYR	b l O t d y R
BLÓTDYRA	b l O t d y R A
BLÓTDYRET	b l O t d y R @ t
BLÓTDYRI	b l O t d y R i
BLÒTE	b l u t a
BLÒTEN	b l u t @ n
BLÒTENE	b l u t E n a
BLÒTER	b l u t @ R
BLÓTET	b l u t @ t
BLÒTET	b l u t @ t
BLÓTI	b l u t i
BLÒTI	b l u t i
BLÒTONE	b l u t u n a
BLÒTOR	b l u t u R
BLÆR	b l a R
BLØ	b l y
BLØR	b l y R
BLØS	b l y s
BLØTT	b l W t
BLØTTS	b l W t s
BLÅSVÊR	b l O s v @ R
BLÅSVÊRA	b l O s v e R A
BLÅSVÊRET	b l O s v e R @ t
BLÅSVÊRI	b l O s v e R i
BÔ	b u
BOKAUTODAFÉANE	b u k a w t u d a f e a n a
BOKAUTODAFÉAR	b u k a w t u d a f e a R
BOKKAFÉANE	b O k a f e a n a
BOKKAFÉAR	b O k a f e a R
BRINGBÆRGELÉ	b R I N b a R g e l e
BRINGBÆRGELÉANE	b R I N b a R g e l e a n a
BRINGBÆRGELÉAR	b R I N b a R g e l e a R
BRINGBÆRGELÉEN	b R I N b a R g e l e @ n
BRINGEBÆRGELÉANE	b R I N e b a R g e l e a n a
BRINGEBÆRGELÉAR	b R I N e b a R g e l e a R
BRÒSA	b R u s A
BRÒSE	b R u s a
BRÒSENE	b R u s E n a
BRÒSER	b R u s @ R
BRÒSONE	b R u s u n a
BRÒSOR	b R u s u R
BROTTVÊR	b R O t v @ R
BROTTVÊRA	b R O t v e R A
BROTTVÊRET	b R O t v e R @ t
BROTTVÊRI	b R O t v e R i
BROTVÊR	b R O t v @ R
BROTVÊRA	b R O t v e R A
BROTVÊRET	b R O t v e R @ t
BROTVÊRI	b R O t v e R i
BRUNDVÊR	b R u n n v @ R
BRUNDVÊRA	b R u n n v e R A
BRUNDVÊRET	b R u n n v e R @ t
BRUNDVÊRI	b R u n n v e R i
BRUNKOLTJØRE	b R u N k O l s y R a
BRUNKULLTJØRE	b R u N k u l s y R a
BRYGGEKJÊL	b R y g E dZ @ l
BRYGGEKJÊLANE	b R y g @ dZ e l a n a
BRYGGEKJÊLAR	b R y g @ dZ e l a R
BRYGGEKJÊLEN	b R y g @ dZ e l @ n
BRYGGJEKJÊL	b R y g j E dZ @ l
BRYGGJEKJÊLANE	b R y g j @ dZ e l a n a
BRYGGJEKJÊLAR	b R y g j @ dZ e l a R
BRYGGJEKJÊLEN	b R y g j @ dZ e l @ n
BRÆKENE	b R E k E n a
BRÆKER	b R E k @ R
BRØK	b R y k
BRØKEN	b R y k @ n
BRØKENE	b R y k E n a
BRØKENES	b R y k e n @ s
BRØKENS	b R y k @ n s
BRØKER	b R y k @ R
BRØKERS	b R y k a S
BRØKS	b R W k s
BRØNT	b R W n t
BRØNTE	b R W n t a
BRÅDVÊR	b R O d v @ R
BRÅDVÊRA	b R O d v e R A
BRÅDVÊRET	b R O d v e R @ t
BRÅDVÊRI	b R O d v e R i
BUFFÉANE	b u f f e a n a
BUFFÉAR	b u f f e a R
BUFÒR	b u f u R
BUFÒRA	b u f u R A
BUFÒRENE	b u f u R E n a
BUFÒRER	b u f u R @ R
BUFÒRI	b u f u R i
BUKÉANE	b u k e a n a
BUKÉAR	b u k e a R
BUVÊR	b u v @ R
BUVÊRA	b u v e R A
BUVÊRET	b u v e R @ t
BUVÊRI	b u v e R i
BYEVÊR	b y e v @ R
BYEVÊRA	b y e v e R A
BYEVÊRET	b y e v e R @ t
BYEVÊRI	b y e v e R i
BYGDEMUSÉ	b y g d e m u s e
BYGDEMUSÉA	b y g d e m u s e A
BYGDEMUSÉET	b y g d e m u s e @ t
BYGDEMUSÉI	b y g d e m u s e i
BYGGEKOMITÉANE	b y g e k u m i t e a n a
BYGGEKOMITÉAR	b y g e k u m i t e a R
BYGGJEKOMITÉ	b y g j e k u m i t e
BYGGJEKOMITÉANE	b y g j e k u m i t e a n a
BYGGJEKOMITÉAR	b y g j e k u m i t e a R
BYGGJEKOMITÉEN	b y g j e k u m i t e @ n
BYMUSÉ	b y m u s e
BYMUSÉA	b y m u s e A
BYMUSÉET	b y m u s e @ t
BYMUSÉI	b y m u s e i
BÆENE	b E E n a
BÆENES	b E e n @ s
BÆR	b a R
BÆRA	b a R A
BÆRAS	b a R a s
BÆRE	b a R a
BÆRENDE	b a R E n n a
BÆRENDES	b a R E n n @ s
BÆRENE	b a R E n a
BÆRENES	b a R e n @ s
BÆRER	b a R @ R
BÆRERS	b a R a S
BÆRES	b a R @ s
BÆRET	b a R @ t
BÆRETS	b a R E t s
BÆRING	b a R I N
BÆRS	b a S
BÆS	b E s
BØ	b y
BØA	b y A
BØAS	b y a s
BØDALEN	b y d a l @ n
BØEN	b y @ n
BØENE	b y E n a
BØENES	b y e n @ s
BØENS	b y @ n s
BØER	b y @ R
BØERS	b y a S
BØET	b y @ t
BØETS	b y E t s
BØFFELLÊR	b W f f E l l @ R
BØFFELLÊRA	b W f f @ l l e R A
BØFFELLÊRET	b W f f @ l l e R @ t
BØFFELLÊRI	b W f f @ l l e R i
BÖHM	b W h m
BØK	b y k
BØKEN	b y k @ n
BØKENE	b y k E n a
BØKENES	b y k e n @ s
BØKENS	b y k @ n s
BØKER	b y k @ R
BØKERS	b y k a S
BØKS	b W k s
BØLA	b y l A
BØLAS	b y l a s
BØLE	b y l a
BØLEN	b y l @ n
BØLENE	b y l E n a
BØLENES	b y l e n @ s
BØLENS	b y l @ n s
BØLER	b y l @ R
BØLERS	b y l a S
BØLES	b y l @ s
BØLET	b y l @ t
BØLETS	b y l E t s
BØNDENE	b W n n E n a
BØNDENES	b W n n e n @ s
BØNN	b W n
BØR	b y R
BØRA	b y R A
BØRAS	b y R a s
BØRE	b y R a
BØREN	b y R @ n
BØRENE	b y R E n a
BØRENES	b y R e n @ s
BØRENS	b y R @ n s
BØRER	b y R @ R
BØRERS	b y R a S
BØRES	b y R @ s
BØRINGENE	b y R I N E n a
BÖRJESSON	b W R j @ s s u n
BØRNES	b W R n @ s
BØRS	b W S
BØRSTAD	b W R S t a d
BØS	b y s
BØS'	b y s
BØST	b W s t
BØSTAD	b W s t a d
BØT	b y t
BØTEN	b y t @ n
BØTENE	b y t E n a
BØTENES	b y t e n @ s
BØTER	b y t @ R
BØTERS	b y t a S
BØVERDALEN	b y v a R d a l @ n
BØVERFJORD	b y v a R f j O R
BØVRE	b W v R a
BØYEVÊR	b y y e v @ R
BØYEVÊRA	b y y e v e R A
BØYEVÊRET	b y y e v e R @ t
BØYEVÊRI	b y y e v e R i
BÅLSTAD	b O l s t a d
BÅSFÔR	b O s f u R
BÅSFÔRA	b O s f u R A
BÅSFÔRANDE	b O s f u R A n n a
BÅSFÔRAR	b O s f u R a R
BÅSFÔRAS	b O s f u R a s
BÅSFÔRAST	b O s f u R A s t
BÅSFÔRE	b O s f u R a
CAFÉ-AU-LAIT	k a f e a w l A I t
CAFÉ-AU-LAITANE	k a f e a w l A I t a n a
CAFÉ-AU-LAITAR	k a f e a w l A I t a R
CAFÉ-AU-LAITEN	k a f e a w l A I t @ n
CENDRÉ	s E n n R e
CENDRÉARE	s E n n R e a R a
CENDRÉAST	s E n n R e A s t
CENDRÉASTE	s E n n R e A s t a
CÉSAR	k e s a R
CHAUSSÉANE	S a w s s e a n a
CHAUSSÉAR	S a w s s e a R
CONSOMMÉANE	k O n s O m m e a n a
CONSOMMÉAR	k O n s O m m e a R
CURAÇAOANE	k u R a k A u a n a
CURAÇAOAR	k u R a k A u a R
DALAVÊR	d a l a v @ R
DALAVÊRANE	d a l a v e R a n a
DALAVÊRAR	d a l a v e R a R
DALAVÊREN	d a l a v e R @ n
DEKKFJØR	d E k f j y R
DEKKFJØRA	d E k f j y R A
DEKKFJØRAS	d E k f j y R a s
DEKKFJØREN	d E k f j y R @ n
DEKKFJØRENE	d E k f j y R E n a
DEKKFJØRENES	d E k f j y R e n @ s
DEKKFJØRENS	d E k f j y R @ n s
DEKKFJØRER	d E k f j y R @ R
DEKKFJØRERS	d E k f j y R a S
DEKKFJØRS	d E k f j W S
DESISJONSKOMITÉANE	d e s I S O n s k u m i t e a n a
DESISJONSKOMITÉAR	d e s I S O n s k u m i t e a R
DIARÉANE	d i a R e a n a
DIARÉAR	d i a R e a R
DIATOMÉANE	d i a t u m e a n a
DIATOMÉAR	d i a t u m e a R
DISKRÉARE	d I s k R e a R a
DISKRÉAST	d I s k R e A s t
DISKRÉASTE	d I s k R e A s t a
DISTRÉARE	d I s t R e a R a
DISTRÉAST	d I s t R e A s t
DISTRÉASTE	d I s t R e A s t a
DRAGÉ	d R a g e
DRAGÉANE	d R a g e a n a
DRAGÉAR	d R a g e a R
DRAGÉEN	d R a g e @ n
DRASJÉANE	d R A S e a n a
DRASJÉAR	d R A S e a R
DREPEVÊR	d R e p e v @ R
DREPEVÊRA	d R e p e v e R A
DREPEVÊRET	d R e p e v e R @ t
DREPEVÊRI	d R e p e v e R i
DRIVFJØR	d R I v f j y R
DRIVFJØRA	d R I v f j y R A
DRIVFJØRAS	d R I v f j y R a s
DRIVFJØREN	d R I v f j y R @ n
DRIVFJØRENE	d R I v f j y R E n a
DRIVFJØRENES	d R I v f j y R e n @ s
DRIVFJØRENS	d R I v f j y R @ n s
DRIVFJØRER	d R I v f j y R @ R
DRIVFJØRERS	d R I v f j y R a S
DRIVFJØRS	d R I v f j W S
DRÒG	d R u g
DRÒGA	d R u g A
DRÒGE	d R u g a
DRÒGENE	d R u g E n a
DRÒGER	d R u g @ R
DRÒGI	d R u j i
DRÒGONE	d R u g u n a
DRÒGOR	d R u g u R
DRÓS	d R u s
DRÓSA	d R u s A
DRÓSENE	d R u s E n a
DRÓSER	d R u s @ R
DRÓSI	d R u s i
DUBLÉANE	d u b l e a n a
DUBLÉAR	d u b l e a R
DUNFJØR	d u n f j y R
DUNFJØRA	d u n f j y R A
DUNFJØRAS	d u n f j y R a s
DUNFJØREN	d u n f j y R @ n
DUNFJØRENE	d u n f j y R E n a
DUNFJØRENES	d u n f j y R e n @ s
DUNFJØRENS	d u n f j y R @ n s
DUNFJØRER	d u n f j y R @ R
DUNFJØRERS	d u n f j y R a S
DUNFJØRS	d u n f j W S
DYREFÔR	d y R e f u R
DYREFÔRA	d y R e f u R A
DYREFÔRET	d y R e f u R @ t
DYREFÔRI	d y R e f u R i
DYSMENORÉANE	d y s m e n u R e a n a
DYSMENORÉAR	d y s m e n u R e a R
DYSPNÉANE	d y s p n e a n a
DYSPNÉAR	d y s p n e a R
DYSPNÉEN	d y s p n e @ n
DÜSSELDORFAR	d y s s @ l l O R f a R
DÜSSELDORFARANE	d y s s @ l l O R f a R a n a
DÜSSELDORFARAR	d y s s @ l l O R f a R a R
DÜSSELDORFAREN	d y s s @ l l O R f a R @ n
DØ	d y
DØD	d y d
DØDEN	d y d @ n
DØDENS	d y d @ n s
DØDER	d y d @ R
DØDS	d W d s
DØHLEN	d W h l @ n
DØM	d y m
DØNT	d W n t
DØNTE	d W n t a
DØNTES	d W n t @ s
DØNTS	d W n t s
DØP	d y p
DØPE	d y p a
DØR	d y R
DØRA	d y R A
DØRAS	d y R a s
DØREN	d y R @ n
DØRENE	d y R E n a
DØRENES	d y R e n @ s
DØRENS	d y R @ n s
DØRER	d y R @ R
DØRERS	d y R a S
DØS	d y s
DØSE	d y s a
DØSEN	d y s @ n
DØSENS	d y s @ n s
DØSER	d y s @ R
DØSES	d y s @ s
ÉIT	e i t
ÉITT	e I t
EKSAMENSKOMITÉ	E k s a m E n s k u m i t e
EKSAMENSKOMITÉANE	E k s a m E n s k u m i t e a n a
EKSAMENSKOMITÉAR	E k s a m E n s k u m i t e a R
EKSAMENSKOMITÉEN	E k s a m E n s k u m i t e @ n
EKSEKUTIVKOMITÉANE	E k s e k u t I v k u m i t e a n a
EKSEKUTIVKOMITÉAR	E k s e k u t I v k u m i t e a R
EKSPOSÉI	E k s p u s e i
ELEVÊR	e l e v @ R
ELEVÊRA	e l e v e R A
ELEVÊRET	e l e v e R @ t
ELEVÊRI	e l e v e R i
ELVÊR	E l v @ R
ELVÊRA	E l v e R A
ELVÊRET	E l v e R @ t
ELVÊRI	E l v e R i
ENDEFÓR	E n n e f u R
ENGSTRÖM	E N s t R y m
ENKÉTANE	E N k e t a n a
ENKÉTAR	E N k e t a R
ENTRÉANE	E n t R e a n a
ENTRÉAR	E n t R e a R
ENTRÉBILLETTANE	E n t R e b I l l E t a n a
ENTRÉBILLETTAR	E n t R e b I l l E t a R
ENTRÉBORD	E n t R e b u R
ENTRÉBORDA	E n t R e b u R d A
ENTRÉBORDET	E n t R e b u R d a
ENTRÉBORDI	E n t R e b u R d i
ENTRÉDØRI	E n t R e d y R i
ENTRÉLYKEL	E n t R e l y k @ l
ENTRÉLYKELEN	E n t R e l y k e l @ n
ENTRÉLYKLANE	E n t R e l y k l a n a
ENTRÉLYKLAR	E n t R e l y k l a R
ENTRÉNYKEL	E n t R e n y k @ l
ENTRÉNYKELEN	E n t R e n y k e l @ n
ENTRÉNYKLANE	E n t R e n y k l a n a
ENTRÉNYKLAR	E n t R e n y k l a R
ENTRÉNØKLANE	E n t R e n W k l a n a
ENTRÉNØKLAR	E n t R e n W k l a R
ENVOYÉANE	E n v u y e a n a
ENVOYÉAR	E n v u y e a R
EPLEGELÉANE	E p l e g e l e a n a
EPLEGELÉAR	E p l e g e l e a R
ETTØRING	E t y R I N
ETTØRINGEN	E t y R I N @ n
ETTØRINGENE	E t y R I N E n a
ETTØRINGENES	E t y R I N e n @ s
ETTØRINGENS	E t y R I N @ n s
ETTØRINGER	E t y R I N @ R
ETTØRINGERS	E t y R I N a S
ETTØRINGS	E t y R I N s
FAIRTRADES	f A I R t R a d e s
FALLVÊR	f A l v @ R
FALLVÊRA	f A l v e R A
FALLVÊRET	f A l v e R @ t
FALLVÊRI	f A l v e R i
FANGLÊR	f A N l @ R
FANGLÊRA	f A N l e R A
FANGLÊRET	f A N l e R @ t
FANGLÊRI	f A N l e R i
FEITEFÔR	f aI t e f u R
FEITEFÔRA	f aI t e f u R A
FEITEFÔRET	f aI t e f u R @ t
FEITEFÔRI	f aI t e f u R i
FEITTLÊR	f aI t l @ R
FEITTLÊRA	f aI t l e R A
FEITTLÊRET	f aI t l e R @ t
FEITTLÊRI	f aI t l e R i
FEMTIØRENE	f E m t i y R E n a
FEMTIØRENES	f E m t i y R e n @ s
FEMTIØRING	f E m t i y R I N
FEMTIØRINGEN	f E m t i y R I N @ n
FEMTIØRINGENE	f E m t i y R I N E n a
FEMTIØRINGENES	f E m t i y R I N e n @ s
FEMTIØRINGENS	f E m t i y R I N @ n s
FEMTIØRINGER	f E m t i y R I N @ R
FEMTIØRINGERS	f E m t i y R I N a S
FEMTIØRINGS	f E m t i y R I N s
FEMTIÅRSJUBILÉ	f E m t i O R S u b i l e
FEMTIÅRSJUBILÉA	f E m t i O R S u b i l e A
FEMTIÅRSJUBILÉET	f E m t i O R S u b i l e @ t
FEMTIÅRSJUBILÉI	f E m t i O R S u b i l e i
FEMØRING	f e m y R I N
FEMØRINGEN	f e m y R I N @ n
FEMØRINGENE	f e m y R I N E n a
FEMØRINGENES	f e m y R I N e n @ s
FEMØRINGENS	f e m y R I N @ n s
FEMØRINGER	f e m y R I N @ R
FEMØRINGERS	f e m y R I N a S
FEMØRINGS	f e m y R I N s
FERDAVÊR	f a R d a v @ R
FERDAVÊRA	f a R d a v e R A
FERDAVÊRET	f a R d a v e R @ t
FERDAVÊRI	f a R d a v e R i
FESTKOMITÉANE	f E s t k u m i t e a n a
FESTKOMITÉAR	f E s t k u m i t e a R
FIKSÉRVÆSKA	f I k s e R v a s k A
FIKSÉRVÆSKE	f I k s e R v a s k a
FIKSÉRVÆSKENE	f I k s e R v a s k E n a
FIKSÉRVÆSKER	f I k s e R v a s k @ R
FIKSÉRVÆSKONE	f I k s e R v a s k u n a
FIKSÉRVÆSKOR	f I k s e R v a s k u R
FINANSKOMITÉANE	f i n A n s k u m i t e a n a
FINANSKOMITÉAR	f i n A n s k u m i t e a R
FINVÊR	f I n v @ R
FINVÊRA	f I n v e R A
FINVÊRET	f I n v e R @ t
FINVÊRI	f I n v e R i
FISKEVÊR	f I s k e v @ R
FISKEVÊRA	f I s k e v e R A
FISKEVÊRET	f I s k e v e R @ t
FISKEVÊRI	f I s k e v e R i
FJØR	f j y R
FJØRA	f j y R A
FJØRAS	f j y R a s
FJØRDRAKT	f j W R d R A k t
FJØRDRAKTA	f j W R d R A k t A
FJØRDRAKTAS	f j W R d R A k t a s
FJØRDRAKTEN	f j W R d R A k t @ n
FJØRDRAKTENE	f j W R d R A k t E n a
FJØRDRAKTENES	f j W R d R A k t e n @ s
FJØRDRAKTENS	f j W R d R A k t @ n s
FJØRDRAKTER	f j W R d R A k t @ R
FJØRDRAKTERS	f j W R d R A k t a S
FJØRDRAKTS	f j W R d R A k t s
FJØRE	f j y R a
FJØREKNAPP	f j y R @ k n A p
FJØREKNAPPEN	f j y R @ k n A p @ n
FJØREKNAPPENE	f j y R @ k n A p E n a
FJØREKNAPPENES	f j y R @ k n A p e n @ s
FJØREKNAPPENS	f j y R @ k n A p @ n s
FJØREKNAPPER	f j y R @ k n A p @ R
FJØREKNAPPERS	f j y R @ k n A p a S
FJØREKNAPPS	f j y R @ k n A p s
FJØREN	f j y R @ n
FJØRENDE	f j y R E n n a
FJØRENDES	f j y R E n n @ s
FJØRENE	f j y R E n a
FJØRENES	f j y R e n @ s
FJØRENS	f j y R @ n s
FJØRER	f j y R @ R
FJØRERS	f j y R a S
FJØRES	f j y R @ s
FJØRET	f j y R @ t
FJØRETE	f j y R e t a
FJØRETES	f j y R e t @ s
FJØRETS	f j y R E t s
FJØREVEIEN	f j y R e v aI @ n
FJØRFE	f j W R f a
FJØRFEA	f j W R f e A
FJØRFEAS	f j W R f e a s
FJØRFEENE	f j W R f e E n a
FJØRFEENES	f j W R f e e n @ s
FJØRFEET	f j W R f e @ t
FJØRFEETS	f j W R f e E t s
FJØRFES	f j W R f @ s
FJØRHAM	f j W R h a m
FJØRHAMMEN	f j W R h A m m @ n
FJØRHAMMENE	f j W R h A m m E n a
FJØRHAMMENES	f j W R h A m m e n @ s
FJØRHAMMENS	f j W R h A m m @ n s
FJØRHAMMER	f j W R h A m m @ R
FJØRHAMMERS	f j W R h A m m a S
FJØRHAMS	f j W R h A m s
FJØRING	f j y R I N
FJØRLETT	f j W R l E t
FJØRLETTE	f j W R l E t a
FJØRLETTES	f j W R l E t @ s
FJØRLETTS	f j W R l E t s
FJØRMADRASS	f j W R m A d R A s
FJØRMADRASS'	f j W R m A d R A s
FJØRMADRASSEN	f j W R m A d R A s s @ n
FJØRMADRASSENE	f j W R m A d R A s s E n a
FJØRMADRASSENES	f j W R m A d R A s s e n @ s
FJØRMADRASSENS	f j W R m A d R A s s @ n s
FJØRMADRASSER	f j W R m A d R A s s @ R
FJØRMADRASSERS	f j W R m A d R A s s a S
FJØRS	f j W S
FJØRSKY	f j W R S y
FJØRSKYA	f j W R S y A
FJØRSKYAS	f j W R S y a s
FJØRSKYEN	f j W R S y @ n
FJØRSKYENE	f j W R S y E n a
FJØRSKYENES	f j W R S y e n @ s
FJØRSKYENS	f j W R S y @ n s
FJØRSKYER	f j W R S y @ R
FJØRSKYERS	f j W R S y a S
FJØRSKYS	f j W R S y s
FJØRTOFT	f j W R t O f t
FJØRVEKT	f j W R v E k t
FJØRVEKTA	f j W R v @ k t A
FJØRVEKTAS	f j W R v @ k t a s
FJØRVEKTEN	f j W R v E k t @ n
FJØRVEKTENE	f j W R v @ k t E n a
FJØRVEKTENES	f j W R v @ k t e n @ s
FJØRVEKTENS	f j W R v E k t @ n s
FJØRVEKTER	f j W R v E k t @ R
FJØRVEKTERE	f j W R v @ k t e R a
FJØRVEKTEREN	f j W R v @ k t e R @ n
FJØRVEKTERENS	f j W R v @ k t e R @ n s
FJØRVEKTERER	f j W R v @ k t e R @ R
FJØRVEKTERERS	f j W R v @ k t e R a S
FJØRVEKTERES	f j W R v @ k t e R @ s
FJØRVEKTERNE	f j W R v @ k t a R n a
FJØRVEKTERNES	f j W R v @ k t a R n @ s
FJØRVEKTERS	f j W R v @ k t a S
FJØRVEKTKLASSA	f j W R v @ k t k l A s s A
FJØRVEKTKLASSAS	f j W R v @ k t k l A s s a s
FJØRVEKTKLASSE	f j W R v @ k t k l A s s a
FJØRVEKTKLASSEN	f j W R v @ k t k l A s s @ n
FJØRVEKTKLASSENE	f j W R v @ k t k l A s s E n a
FJØRVEKTKLASSENES	f j W R v @ k t k l A s s e n @ s
FJØRVEKTKLASSENS	f j W R v @ k t k l A s s @ n s
FJØRVEKTKLASSER	f j W R v @ k t k l A s s @ R
FJØRVEKTKLASSERS	f j W R v @ k t k l A s s a S
FJØRVEKTKLASSES	f j W R v @ k t k l A s s @ s
FJØRVEKTS	f j W R v E k t s
FJØRVEKTSKLASSA	f j W R v @ k t s k l A s s A
FJØRVEKTSKLASSAS	f j W R v @ k t s k l A s s a s
FJØRVEKTSKLASSE	f j W R v @ k t s k l A s s a
FJØRVEKTSKLASSEN	f j W R v @ k t s k l A s s @ n
FJØRVEKTSKLASSENE	f j W R v @ k t s k l A s s E n a
FJØRVEKTSKLASSENES	f j W R v @ k t s k l A s s e n @ s
FJØRVEKTSKLASSENS	f j W R v @ k t s k l A s s @ n s
FJØRVEKTSKLASSER	f j W R v @ k t s k l A s s @ R
FJØRVEKTSKLASSERS	f j W R v @ k t s k l A s s a S
FJØRVEKTSKLASSES	f j W R v @ k t s k l A s s @ s
FLAGEVÊR	f l a g e v @ R
FLAGEVÊRA	f l a g e v e R A
FLAGEVÊRET	f l a g e v e R @ t
FLAGEVÊRI	f l a g e v e R i
FLASKEFÔRI	f l A s k e f u R i
FLATFÔR	f l A t f u R
FLATFÔRA	f l A t f u R A
FLATFÔRET	f l A t f u R @ t
FLATFÔRI	f l A t f u R i
FLESJØ	f l E S y
FLÒT	f l u t
FLÒTA	f l u t A
FLÒTARE	f l u t a R a
FLÒTAST	f l u t A s t
FLÒTASTE	f l u t A s t a
FLÒTE	f l u t a
FLÒTENE	f l u t E n a
FLÒTER	f l u t @ R
FLÒTET	f l u t @ t
FLÒTI	f l u t i
FLÒTT	f l O t
FLOVÊR	f l u v @ R
FLOVÊRA	f l u v e R A
FLOVÊRET	f l u v e R @ t
FLOVÊRI	f l u v e R i
FLYGEIDÉANE	f l y j aI d e a n a
FLYGEIDÉAR	f l y j aI d e a R
FLÆ	f l E
FLÆA	f l E A
FLÆAS	f l E a s
FLÆDD	f l a d
FLÆDDE	f l a d a
FLÆDDES	f l a d @ s
FLÆDDS	f l a d s
FLÆENDE	f l E E n n a
FLÆENDES	f l E E n n @ s
FLÆENE	f l E E n a
FLÆENES	f l E e n @ s
FLÆER	f l E @ R
FLÆERS	f l E a S
FLÆING	f l E I N
FLÆR	f l a R
FLÆS	f l E s
FLØ	f l y
FLØ	f l y
FLØA	f l y A
FLØAS	f l y a s
FLØDD	f l W d
FLØDDE	f l W d a
FLØDDES	f l W d @ s
FLØDDS	f l W d s
FLØE	f l y a
FLØENDE	f l y E n n a
FLØENDES	f l y E n n @ s
FLØENE	f l y E n a
FLØENES	f l y e n @ s
FLØERE	f l y e R a
FLØET	f l y @ t
FLØETS	f l y E t s
FLØING	f l y I N
FLØR	f l y R
FLØRNE	f l W R n a
FLØRNES	f l W R n @ s
FLØRS	f l W S
FLØS	f l y s
FLØTE	f l y t a
FLØTEN	f l y t @ n
FLØTENE	f l y t E n a
FLØTENES	f l y t e n @ s
FLØTENS	f l y t @ n s
FLØTER	f l y t @ R
FLØTERS	f l y t a S
FLØTES	f l y t @ s
FLØTT	f l W t
FLØTTEN	f l W t @ n
FLØTTEN	f l W t @ n
FLØTTS	f l W t s
FOAJÉANE	f u a j e a n a
FOAJÉAR	f u a j e a R
FOLKEMUSÉI	f O l k e m u s e i
FÓR	f u R
FÒR	f u R
FÔR	f u R
FÓRA	f u R A
FÒRA	f u R A
FÔRA	f u R A
FÒRANDE	f u R A n n a
FÔRANDE	f u R A n n a
FÒRAR	f u R a R
FÔRAR	f u R a R
FÓRARE	f u R a R a
FÒRAS	f u R a s
FÔRAS	f u R a s
FÓRAST	f u R A s t
FÒRAST	f u R A s t
FÔRAST	f u R A s t
FÓRASTE	f u R A s t a
FÔRAVL	f u R A v l
FÔRAVLANE	f u R A v l a n a
FÔRAVLAR	f u R A v l a R
FÔRAVLEN	f u R A v l @ n
FÔRAVLING	f u R A v l I N
FÔRAVLINGA	f u R A v l I N A
FÔRAVLINGANE	f u R A v l I N a n a
FÔRAVLINGAR	f u R A v l I N a R
FÔRAVLINGI	f u R A v l I N i
FÔRAVLSBRUK	f u R A v l s b R u k
FÔRAVLSBRUKA	f u R A v l s b R u k A
FÔRAVLSBRUKET	f u R A v l s b R u k @ t
FÔRAVLSBRUKI	f u R A v l s b R u dZ i
FÔRBLANDINGANE	f O R b l A n n I N a n a
FÔRBLANDINGAR	f O R b l A n n I N a R
FÔRBLANDINGI	f O R b l A n n I N i
FÔRBRUK	f O R b R u k
FÔRBRUKA	f O R b R u k A
FÔRBRUKET	f O R b R u k @ t
FÔRBRUKI	f O R b R u dZ i
FÔRDYRKING	f O R d y R dZ I N
FÔRDYRKINGA	f O R d y R dZ I N A
FÔRDYRKINGANE	f O R d y R dZ I N a n a
FÔRDYRKINGAR	f O R d y R dZ I N a R
FÔRDYRKINGI	f O R d y R dZ I N i
FÓRE	f u R a
FÒRE	f u R a
FOREDRAGSTURNÉ	f u R @ d R A g s t u R n e
FOREDRAGSTURNÉANE	f u R @ d R A g s t u R n e a n a
FOREDRAGSTURNÉAR	f u R @ d R A g s t u R n e a R
FOREDRAGSTURNÉEN	f u R @ d R A g s t u R n e @ n
FÔREINING	f u R aI n I N
FÔREININGA	f u R aI n I N A
FÔREININGANE	f u R aI n I N a n a
FÔREININGAR	f u R aI n I N a R
FÔREININGI	f u R aI n I N i
FÔREMNA	f u R @ m n A
FÔREMNE	f u R E m n a
FÔREMNET	f u R E m n @ t
FÔREMNI	f u R @ m n i
FÒREN	f u R @ n
FÓRENE	f u R E n a
FÒRENE	f u R E n a
FÒRENES	f u R e n @ s
FÒRENS	f u R @ n s
FÓRER	f u R @ R
FÒRER	f u R @ R
FÔRER	f u R @ R
FÒRERS	f u R a S
FÔRERT	f u R a R t
FÔRERTA	f u R a R t A
FÔRERTENE	f u R a R t E n a
FÔRERTER	f u R a R t @ R
FÔRERTI	f u R a R t i
FÔRERTRA	f u R a R t R A
FÔRERTRI	f u R a R t R i
FÓRET	f u R @ t
FÔRET	f u R @ t
FÔRETE	f u R e t a
FÔRETES	f u R e t @ s
FÔRETS	f u R E t s
FORFÓR	f O R f u R
FORFÓRS	f O R f O S
FORFÓRST	f O R f O R S t
FÔRGANGANE	f O R g A N a n a
FÔRGANGAR	f O R g A N a R
FÔRHAUST	f O R h a w s t
FÔRHAUSTA	f O R h a w s t A
FÔRHAUSTANDE	f O R h a w s t A n n a
FÔRHAUSTAR	f O R h a w s t a R
FÔRHAUSTARANE	f O R h a w s t a R a n a
FÔRHAUSTARAR	f O R h a w s t a R a R
FÔRHAUSTAREN	f O R h a w s t a R @ n
FÔRHAUSTAS	f O R h a w s t a s
FÔRHAUSTAST	f O R h a w s t A s t
FÔRHAUSTE	f O R h a w s t a
FÒRI	f u R i
FÔRI	f u R i
FÒRING	f u R I N
FÔRING	f u R I N
FÔRINGA	f u R I N A
FÒRINGANE	f u R I N a n a
FÔRINGANE	f u R I N a n a
FÒRINGAR	f u R I N a R
FÔRINGAR	f u R I N a R
FÒRINGEN	f u R I N @ n
FÔRINGEN	f u R I N @ n
FÔRINGI	f u R I N i
FÔRINGSEMNA	f u R I N s E m n A
FÔRINGSEMNE	f u R I N s E m n a
FÔRINGSEMNET	f u R I N s E m n @ t
FÔRINGSEMNI	f u R I N s E m n i
FÔRINGSFORSØK	f u R I N s f O R S y k
FÔRINGSFORSØKA	f u R I N s f O R S y k A
FÔRINGSFORSØKET	f u R I N s f O R S y k @ t
FÔRINGSFORSØKI	f u R I N s f O R S y dZ i
FÔRINGSKRØTER	f u R I N s k R y t @ R
FÔRINGSKRØTERA	f u R I N s k R y t e R A
FÔRINGSKRØTERET	f u R I N s k R y t e R @ t
FÔRINGSKRØTERI	f u R I N s k R y t e R i
FÔRINGSKRØTTER	f u R I N s k R W t @ R
FÔRINGSKRØTTERA	f u R I N s k R W t e R A
FÔRINGSKRØTTERET	f u R I N s k R W t e R @ t
FÔRINGSKRØTTERI	f u R I N s k R W t e R i
FÔRINGSTID	f u R I N s t i d
FÔRINGSTIDA	f u R I N s t i d A
FÔRINGSTIDENE	f u R I N s t i d E n a
FÔRINGSTIDER	f u R I N s t i d @ R
FÔRINGSTIDI	f u R I N s t i d i
FORKJØL	f O R dZ y l
FORKJØLE	f O R dZ y l a
FORKJØLENDE	f O R dZ y l E n n a
FORKJØLENDES	f O R dZ y l E n n @ s
FORKJØLER	f O R dZ y l @ R
FORKJØLES	f O R dZ y l @ s
FORKJØLING	f O R dZ y l I N
FORKJØLT	f O R dZ W l t
FORKJØLTE	f O R dZ W l t a
FORKJØLTES	f O R dZ W l t @ s
FORKJØLTS	f O R dZ W l t s
FÔRKNIPONE	f O R k n i p u n a
FÔRKNIPOR	f O R k n i p u R
FÔRKRØTER	f O R k R y t @ R
FÔRKRØTERA	f O R k R y t e R A
FÔRKRØTERET	f O R k R y t e R @ t
FÔRKRØTERI	f O R k R y t e R i
FÔRKRØTTER	f O R k R W t @ R
FÔRKRØTTERA	f O R k R W t e R A
FÔRKRØTTERET	f O R k R W t e R @ t
FÔRKRØTTERI	f O R k R W t e R i
FÔRKU	f O R k u
FÔRKUA	f O R k u A
FÔRKUI	f O R k u I
FÔRKVOTER	f O R k v u t @ R
FÔRKYR	f O R dZ y R
FÔRKYRNE	f O R dZ y R n a
FÔRLASS	f O R l A s
FÔRLASSA	f O R l A s s A
FÔRLASSET	f O R l A s s @ t
FÔRLASSI	f O R l A s s i
FÔRLAUS	f O R l a w s
FÔRLAUSARE	f O R l a w s a R a
FÔRLAUSAST	f O R l a w s A s t
FÔRLAUSASTE	f O R l a w s A s t a
FÔRLAUSE	f O R l a w s a
FÔRLAUST	f O R l a w s t
FÔRLEIGA	f O R l aI g A
FÔRLEIGE	f O R l aI g a
FÔRLEIGENE	f O R l aI g E n a
FÔRLEIGER	f O R l aI g @ R
FÔRLEIGONE	f O R l aI g u n a
FÔRLEIGOR	f O R l aI g u R
FORLÉT	f O R l e t
FORLÈT	f O R l @ t
FÔRLØA	f O R l y A
FÔRLØE	f O R l y a
FÔRLØENE	f O R l y E n a
FÔRLØER	f O R l y @ R
FÔRLØONE	f O R l y u n a
FÔRLØOR	f O R l y u R
FÔRLØYSA	f O R l y y s A
FÔRLØYSE	f O R l y y s a
FÔRLØYSENE	f O R l y y s E n a
FÔRLØYSER	f O R l y y s @ R
FÔRLØYSONE	f O R l y y s u n a
FÔRLØYSOR	f O R l y y s u R
FÔRMERGKÅL	f O R m a R g k o l
FÔRMERGKÅLANE	f O R m a R g k o l a n a
FÔRMERGKÅLAR	f O R m a R g k o l a R
FÔRMERGKÅLEN	f O R m a R g k o l @ n
FÔRMJØL	f O R m j y l
FÔRMJØLA	f O R m j y l A
FÔRMJØLET	f O R m j y l @ t
FÔRMJØLI	f O R m j y l i
FÔRMO	f O R m u
FÔRMOA	f O R m u A
FÔRMOET	f O R m O a t
FÔRMOI	f O R m O I
FORMÆL	f O R m E l
FÓRN	f O R n
FÓRNA	f O R n A
FÔRNAUD	f O R n a w d
FÔRNAUDA	f O R n a w d A
FÔRNAUDENE	f O R n a w d E n a
FÔRNAUDER	f O R n a w d @ R
FÔRNAUDI	f O R n a w d i
FÔRNAUT	f O R n a w t
FÔRNAUTA	f O R n a w t A
FÔRNAUTET	f O R n a w t @ t
FÔRNAUTI	f O R n a w t i
FÓRNENE	f O R n E n a
FÔRNEPA	f O R n e p A
FÔRNEPE	f O R n e p a
FÔRNEPENE	f O R n e p E n a
FÔRNEPER	f O R n e p @ R
FÔRNEPONE	f O R n e p u n a
FÔRNEPOR	f O R n e p u R
FÓRNER	f O R n @ R
FÓRNI	f O R n i
FÔRNØD	f O R n y d
FÔRNØDA	f O R n y d A
FÔRNØDENE	f O R n y d E n a
FÔRNØDER	f O R n y d @ R
FÔRNØDI	f O R n y d i
FÓRONE	f u R u n a
FÒRONE	f u R u n a
FÔRONN	f u R O n
FÔRONNA	f u R O n n A
FÔRONNENE	f u R O n n E n a
FÔRONNER	f u R O n n @ R
FÔRONNI	f u R O n n i
FÓROR	f u R u R
FÒROR	f u R u R
FÔRPLANTA	f O R p l A n t A
FÔRPLANTANE	f O R p l A n t a n a
FÔRPLANTAR	f O R p l A n t a R
FÔRPLANTE	f O R p l A n t a
FÔRPLANTEN	f O R p l A n t @ n
FÔRPLANTENE	f O R p l A n t E n a
FÔRPLANTER	f O R p l A n t @ R
FÔRPLANTONE	f O R p l A n t u n a
FÔRPLANTOR	f O R p l A n t u R
FORRÆDER	f O R R E d @ R
FÒRS	f O S
FÒRSKOT	f O R S k u t
FÒRSKOTA	f O R S k u t A
FÒRSKOTET	f O R S k u t @ t
FÒRSKOTI	f O R S k u t i
FÒRSKOTT	f O R S k O t
FÒRSKOTTA	f O R S k O t A
FÒRSKOTTET	f O R S k O t @ t
FÒRSKOTTI	f O R S k O t i
FÔRSLAG	f O R S l a g
FÔRSTOFF	f O R S t O f f
FÔRSTOFFA	f O R S t O f f A
FÔRSTOFFET	f O R S t O f f @ t
FÔRSTOFFI	f O R S t O f f i
FORSTØTT	f O R S t W t
FORSTØTTE	f O R S t W t a
FORSTØTTES	f O R S t W t @ s
FORSTØTTS	f O R S t W t s
FORSTÅELSE	f O R S t o a l s a
FORSVARSATTACHÉANE	f O R S v A R S A t A S e a n a
FORSVARSATTACHÉAR	f O R S v A R S A t A S e a R
FÓRT	f w R t
FORTAUSKAFÉANE	f w R t a w s k a f e a n a
FORTAUSKAFÉAR	f w R t a w s k a f e a R
FORVÊR	f O R v @ R
FORVÊRA	f O R v e R A
FÔRVERD	f O R v a R
FÔRVERDA	f O R v a R d A
FÔRVERDE	f O R v a R d a
FÔRVERDET	f O R v a R d a
FÔRVERDI	f O R v a R d i
FÔRVERDIANE	f O R v a R d i a n a
FÔRVERDIAR	f O R v a R d i a R
FÔRVERDIEN	f O R v a R d i @ n
FORVÊRET	f O R v e R @ t
FORVÊRI	f O R v e R i
FORÆR	f u R a R
FÔRÅR	f u R o R
FÔRÅRA	f u R o R A
FÔRÅRET	f u R o R @ t
FÔRÅRI	f u R o R i
FÓS	f u s
FÓSARE	f u s a R a
FÓSAST	f u s A s t
FÓSASTE	f u s A s t a
FÓSE	f u s a
FÓSEN	f u s @ n
FÓSENT	f u s E n t
FÓSI	f u s i
FÓSN	f O s n
FÓSNA	f O s n A
FÓSNANDE	f O s n A n n a
FÓSNAR	f O s n a R
FÓSNARE	f O s n a R a
FÓSNAS	f O s n a s
FÓSNAST	f O s n A s t
FÓSNASTE	f O s n A s t a
FÓSNE	f O s n a
FÓST	f w s t
FRELSESARMÉANE	f R E l s e s A R m e a n a
FRELSESARMÉAR	f R E l s e s A R m e a R
FRELSESARMÉMØTI	f R E l s e s A R m e m y t i
FRELSESARMÉOFFISERANE	f R E l s e s A R m e O f f i s e R a n a
FRELSESARMÉOFFISERAR	f R E l s e s A R m e O f f i s e R a R
FRELSESARMÉSOLDATANE	f R E l s e s A R m e s O l l a t a n a
FRELSESARMÉSOLDATAR	f R E l s e s A R m e s O l l a t a R
FREMSTÅ	f R E m s t o
FRIKASSÉANE	f R i k A s s e a n a
FRIKASSÉAR	f R i k A s s e a R
FROSTVÊR	f R w s t v @ R
FROSTVÊRA	f R w s t v e R A
FROSTVÊRET	f R w s t v e R @ t
FROSTVÊRI	f R w s t v e R i
FROTTÉANE	f R O t e a n a
FROTTÉAR	f R O t e a R
FROTTÉHANDDUK	f R O t e h A n n d u k
FROTTÉHANDDUKANE	f R O t e h A n n d u k a n a
FROTTÉHANDDUKAR	f R O t e h A n n d u k a R
FROTTÉHANDDUKEN	f R O t e h A n n d u k @ n
FROTTÉHANDKLEA	f R O t e h A n n k l e A
FROTTÉHANDKLEDA	f R O t e h A n n k l e d A
FROTTÉHANDKLEDE	f R O t e h A n n k l e d a
FROTTÉHANDKLEDET	f R O t e h A n n k l e d a
FROTTÉHANDKLEDI	f R O t e h A n n k l e d i
FROTTÉHANDKLEET	f R O t e h A n n k l e @ t
FROTTÉHANDKLEI	f R O t e h A n n k l aI
FROTTÉSOKK	f R O t e s O k
FROTTÉSOKKANE	f R O t e s O k a n a
FROTTÉSOKKAR	f R O t e s O k a R
FROTTÉSOKKEN	f R O t e s O k @ n
FROTTÉSTOFFI	f R O t e s t O f f i
FROTTÉTY	f R O t e t y
FROTTÉTYA	f R O t e t y A
FROTTÉTYET	f R O t e t y @ t
FROTTÉTYI	f R O t e t y i
FROTTÉTØYA	f R O t e t y y A
FROTTÉTØYI	f R O t e t y y i
FRUKTGELÉ	f R u k t g e l e
FRUKTGELÉANE	f R u k t g e l e a n a
FRUKTGELÉAR	f R u k t g e l e a R
FRUKTGELÉEN	f R u k t g e l e @ n
FRØ	f R y
FRÅHALDSKAFÉ	f R o h A l l s k a f e
FRÅHALDSKAFÉANE	f R o h A l l s k a f e a n a
FRÅHALDSKAFÉAR	f R o h A l l s k a f e a R
FRÅHALDSKAFÉEN	f R o h A l l s k a f e @ n
FULLMAKTSKOMITÉ	f u l m A k t s k u m i t e
FULLMAKTSKOMITÉANE	f u l m A k t s k u m i t e a n a
FULLMAKTSKOMITÉAR	f u l m A k t s k u m i t e a R
FULLMAKTSKOMITÉEN	f u l m A k t s k u m i t e @ n
FURÉR	f u R e R
FURÉRANE	f u R e R a n a
FURÉRAR	f u R e R a R
FURÉREN	f u R e R @ n
FYLKESMUSÉ	f y l k @ s m u s e
FYLKESMUSÉA	f y l k @ s m u s e A
FYLKESMUSÉET	f y l k @ s m u s e @ t
FYLKESMUSÉI	f y l k @ s m u s e i
FØ	f y
FØENDE	f y E n n a
FØENDES	f y E n n @ s
FØING	f y I N
FØL	f y l
FØLE	f y l a
FØLENDE	f y l E n n a
FØLENDES	f y l E n n @ s
FØLER	f y l @ R
FØLERE	f y l e R a
FØLERES	f y l e R @ s
FØLES	f y l @ s
FØLING	f y l I N
FØLS	f W l s
FØLT	f W l t
FØLTE	f W l t a
FØLTES	f W l t @ s
FØLTS	f W l t s
FØNE	f y n a
FØR	f y R
FÖR	f y R
FØRA	f y R A
FØRE	f y R a
FØREDRAGSTURNÉ	f y R @ d R A g s t u R n e
FØREDRAGSTURNÉANE	f y R @ d R A g s t u R n e a n a
FØREDRAGSTURNÉAR	f y R @ d R A g s t u R n e a R
FØREDRAGSTURNÉEN	f y R @ d R A g s t u R n e @ n
FØRENDE	f y R E n n a
FØRENDES	f y R E n n @ s
FØRENE	f y R E n a
FØRER	f y R @ R
FØRERS	f y R a S
FØRES	f y R @ s
FØRET	f y R @ t
FØRING	f y R I N
FØRINGEN	f y R I N @ n
FØRINGENE	f y R I N E n a
FØRINGENES	f y R I N e n @ s
FØRINGENS	f y R I N @ n s
FØRINGER	f y R I N @ R
FØRINGERS	f y R I N a S
FØRINGS	f y R I N s
FØRS	f W S
FØS	f y s
FØTAL	f y t a l
FØTT	f W t
FØTTE	f W t a
FØTTES	f W t @ s
FØTTS	f W t s
FØYKEVÊR	f y y k e v @ R
FØYKEVÊRA	f y y k e v e R A
FØYKEVÊRET	f y y k e v e R @ t
FØYKEVÊRI	f y y k e v e R i
FØYKJEVÊR	f y y dZ e v @ R
FØYKJEVÊRA	f y y dZ e v e R A
FØYKJEVÊRET	f y y dZ e v e R @ t
FØYKJEVÊRI	f y y dZ e v e R i
FÅREFRIKASSÉANE	f o R @ f R i k A s s e a n a
FÅREFRIKASSÉAR	f o R @ f R i k A s s e a R
GARDFÓR	g A R d f u R
GELÉAKTIGARE	g e l e A k t i g a R a
GELÉAKTIGAST	g e l e A k t i g A s t
GELÉAKTIGASTE	g e l e A k t i g A s t a
GELÉANE	g e l e a n a
GELÉAR	g e l e a R
GELÉPULVER	g e l e p u l v @ R
GELÉPULVERA	g e l e p u l v e R A
GELÉPULVERET	g e l e p u l v e R @ t
GELÉPULVERI	g e l e p u l v e R i
GELÉVORE	g e l e v u R a
GELÉVOREN	g e l e v u R @ n
GELÉVORI	g e l e v u R i
GELÉVORNARE	g e l e v O R n a R a
GELÉVORNAST	g e l e v O R n A s t
GELÉVORNASTE	g e l e v O R n A s t a
GELÉVORNE	g e l e v O R n a
GÊNE	g e n a
GÊNES	g e n @ s
GENÉVE	g e n e v a
GJELDVÊR	j E l l v @ R
GJELDVÊRA	j E l l v e R A
GJELDVÊRET	j E l l v e R @ t
GJELDVÊRI	j E l l v e R i
GJENDØPER	j E n n y p @ R
GJENDØPERS	j E n n y p a S
GJØR	j y R
GJØRE	j y R a
GJØREN	j y R @ n
GJØRENDE	j y R E n n a
GJØRENDES	j y R E n n @ s
GJØRENS	j y R @ n s
GJØRES	j y R @ s
GJØRING	j y R I N
GJØRS	j W S
GJØSENE	j y s E n a
GJØSENES	j y s e n @ s
GJØSER	j y s @ R
GJØSERS	j y s a S
GJØV	j y v
GLACÉANE	g l a k e a n a
GLACÉAR	g l a k e a R
GLACÉHANSKANE	g l a k e h A n s k a n a
GLACÉHANSKAR	g l a k e h A n s k a R
GLACÉLÊR	g l a k e l @ R
GLACÉLÊRA	g l a k e l e R A
GLACÉLÊRET	g l a k e l e R @ t
GLACÉLÊRI	g l a k e l e R i
GLYTTEVÊR	g l y t e v @ R
GLYTTEVÊRA	g l y t e v e R A
GLYTTEVÊRET	g l y t e v e R @ t
GLYTTEVÊRI	g l y t e v e R i
GLØTTEVÊR	g l W t e v @ R
GLØTTEVÊRA	g l W t e v e R A
GLØTTEVÊRET	g l W t e v e R @ t
GLØTTEVÊRI	g l W t e v e R i
GÒDANE	g u d a n a
GÒDAR	g u d a R
GÒDE	g u d a
GÒDEN	g u d @ n
GÒDORD	g u d O R
GÒDORDA	g u d O R d A
GÒDORDET	g u d O R d a
GÒDORDI	g u d O R d i
GÒDORDSMANN	g u d O R d s m A n
GÒDORDSMANNEN	g u d O R d s m A n n @ n
GÒDORDSMENN	g u d O R d s m E n
GÒDORDSMENNENE	g u d O R d s m E n n E n a
GÒDORDSMENNER	g u d O R d s m E n n @ R
GODVÊR	g O d v @ R
GODVÊRA	g O d v e R A
GODVÊRET	g O d v e R @ t
GODVÊRI	g O d v e R i
GODVÊRSBOLK	g O d v a R S b O l k
GODVÊRSBOLKANE	g O d v a R S b O l k a n a
GODVÊRSBOLKAR	g O d v a R S b O l k a R
GODVÊRSBOLKEN	g O d v a R S b O l k @ n
GODVÊRSDAG	g O d v a R S d a g
GODVÊRSDAGANE	g O d v a R S d a g a n a
GODVÊRSDAGAR	g O d v a R S d a g a R
GODVÊRSDAGEN	g O d v a R S d a g @ n
GODVÊRSHAUS	g O d v a R S h a w s
GODVÊRSHAUSANE	g O d v a R S h a w s a n a
GODVÊRSHAUSAR	g O d v a R S h a w s a R
GODVÊRSHAUSE	g O d v a R S h a w s a
GODVÊRSHAUSEN	g O d v a R S h a w s @ n
GODVÊRSNATT	g O d v a R S n A t
GODVÊRSNATTA	g O d v a R S n A t A
GODVÊRSNATTI	g O d v a R S n A t i
GODVÊRSNETTENE	g O d v a R S n E t E n a
GODVÊRSNETTER	g O d v a R S n E t @ R
GODVÊRSPERIODANE	g O d v a R S p e R i u d a n a
GODVÊRSPERIODAR	g O d v a R S p e R i u d a R
GODVÊRSPERIODE	g O d v a R S p e R i u d a
GODVÊRSPERIODEN	g O d v a R S p e R i u d @ n
GODVÊRSRI	g O d v a R S R i
GODVÊRSRIA	g O d v a R S R i A
GODVÊRSRIENE	g O d v a R S R i E n a
GODVÊRSRIER	g O d v a R S R i @ R
GODVÊRSRII	g O d v a R S R i i
GODVÊRSSKY	g O d v a R S S y
GODVÊRSSKYA	g O d v a R S S y A
GODVÊRSSKYENE	g O d v a R S S y E n a
GODVÊRSSKYER	g O d v a R S S y @ R
GODVÊRSSKYI	g O d v a R S S y i
GONORÉANE	g u n u R e a n a
GONORÉAR	g u n u R e a R
GÒV	g u v
GÒVA	g u v A
GÒVET	g u v @ t
GÒVI	g u v i
GRAPSEVÊR	g R A p s e v @ R
GRAPSEVÊRA	g R A p s e v e R A
GRAPSEVÊRET	g R A p s e v e R @ t
GRAPSEVÊRI	g R A p s e v e R i
GRAVÊR	g R a v @ R
GRAVÊRANE	g R a v e R a n a
GRAVÊRAR	g R a v e R a R
GRAVÊREN	g R a v e R @ n
GRISEVÊR	g R i s e v @ R
GRISEVÊRA	g R i s e v e R A
GRISEVÊRET	g R i s e v e R @ t
GRISEVÊRI	g R i s e v e R i
GRORVÊR	g R O R v @ R
GRORVÊRA	g R O R v e R A
GRORVÊRET	g R O R v e R @ t
GRORVÊRI	g R O R v e R i
GRÓV	g R u v
GRÒV	g R u v
GRÓVA	g R u v A
GRÒVA	g R u v A
GRÒVENE	g R u v E n a
GROVÊR	g R u v @ R
GRÒVER	g R u v @ R
GROVÊRA	g R u v e R A
GROVÊRET	g R u v e R @ t
GROVÊRI	g R u v e R i
GROVFÔRA	g R O v f u R A
GROVFÔRET	g R O v f u R @ t
GROVFÔRI	g R O v f u R i
GRÓVI	g R u v i
GRÒVI	g R u v i
GRÜN	g R y n
GRÜNDERANE	g R y n n e R a n a
GRÜNDERFORTENEST	g R y n n a R f w R t e n E s t
GRÜNDERFORTENESTA	g R y n n a R f w R t e n E s t A
GRÜNDERFORTENESTE	g R y n n a R f w R t e n E s t a
GRÜNDERFORTENESTENE	g R y n n a R f w R t e n E s t E n a
GRÜNDERFORTENESTER	g R y n n a R f w R t e n E s t @ R
GRÜNDERFORTENESTI	g R y n n a R f w R t e n E s t i
GRÜNDERFORTENESTONE	g R y n n a R f w R t e n E s t u n a
GRÜNDERFORTENESTOR	g R y n n a R f w R t e n E s t u R
GRØ	g R y
GRØDEVÊR	g R y d e v @ R
GRØDEVÊRA	g R y d e v e R A
GRØDEVÊRET	g R y d e v e R @ t
GRØDEVÊRI	g R y d e v e R i
GRØN	g R y n
GRØNE	g R y n a
GRØNES	g R y n @ s
GRØNFÔRA	g R W n f u R A
GRØNFÔRET	g R W n f u R @ t
GRØNFÔRI	g R W n f u R i
GRØS	g R y s
GRØT	g R y t
GRØTEN	g R y t @ n
GRØTENS	g R y t @ n s
GRØTER	g R y t @ R
GRØTS	g R W t s
GRÅVÊR	g R o v @ R
GRÅVÊRA	g R o v e R A
GRÅVÊRET	g R o v e R @ t
GRÅVÊRI	g R o v e R i
GRÅVÊRSDAG	g R o v a R S d a g
GRÅVÊRSDAGANE	g R o v a R S d a g a n a
GRÅVÊRSDAGAR	g R o v a R S d a g a R
GRÅVÊRSDAGEN	g R o v a R S d a g @ n
GYLLENLÊR	j y l l E n l @ R
GYLLENLÊRA	j y l l @ n l e R A
GYLLENLÊRET	j y l l @ n l e R @ t
GYLLENLÊRI	j y l l @ n l e R i
GÆREN	g a R @ n
GÆRENS	g a R @ n s
GÖRAN	g y R a n
GØRE	g y R a
GØTA	g y t A
GØTEBORG	g y t e b O R g
HALEFJØR	h a l @ f j y R
HALEFJØRA	h a l @ f j y R A
HALEFJØRAS	h a l @ f j y R a s
HALEFJØREN	h a l @ f j y R @ n
HALEFJØRENE	h a l @ f j y R E n a
HALEFJØRENES	h a l @ f j y R e n @ s
HALEFJØRENS	h a l @ f j y R @ n s
HALEFJØRER	h a l @ f j y R @ R
HALEFJØRERS	h a l @ f j y R a S
HALEFJØRS	h a l @ f j W S
HALMFÔR	h A l m f u R
HALMFÔRA	h A l m f u R A
HALMFÔRET	h A l m f u R @ t
HALMFÔRI	h A l m f u R i
HANDELSATTACHÉ	h A n n @ l s A t A S e
HANDELSATTACHÉANE	h A n n @ l s A t A S e a n a
HANDELSATTACHÉAR	h A n n @ l s A t A S e a R
HANDELSATTACHÉEN	h A n n @ l s A t A S e @ n
HANDELSFLÒTANE	h A n n @ l s f l u t a n a
HANDELSFLÒTAR	h A n n @ l s f l u t a R
HANDELSFLÒTE	h A n n @ l s f l u t a
HANDELSFLÒTEN	h A n n @ l s f l u t @ n
HANDFÓR	h A n n f u R
HARDVÊR	h A R d v @ R
HARDVÊRA	h A R d v e R A
HARDVÊRET	h A R d v e R @ t
HARDVÊRI	h A R d v e R i
HAUGRÒKA	h a w g R u k A
HAUGRÒKAARE	h a w g R u k o R a
HAUGRÒKAAST	h a w g R u k O s t
HAUGRÒKAASTE	h a w g R u k O s t a
HEDSTRÖM	h E d s t R y m
HELLSTRØM	h E l s t R y m
HELTEDØD	h E l t e d y d
HELTEDØDEN	h E l t e d y d @ n
HELTEDØDENS	h E l t e d y d @ n s
HELTEDØDS	h E l t e d W d s
HERMUSÉ	h a R m u s e
HERMUSÉA	h a R m u s e A
HERMUSÉANE	h a R m u s e a n a
HERMUSÉAR	h a R m u s e a R
HERMUSÉEN	h a R m u s e @ n
HERMUSÉET	h a R m u s e @ t
HERMUSÉI	h a R m u s e i
HJELPEFÔRA	j E l p e f u R A
HJELPEFÔRET	j E l p e f u R @ t
HJELPEFÔRI	j E l p e f u R i
HÓL	h u l
HÒL	h u l
HÓLA	h u l A
HÒLA	h u l A
HÓLANDE	h u l A n n a
HÒLANDE	h u l A n n a
HÓLANE	h u l a n a
HÓLAR	h u l a R
HÒLAR	h u l a R
HÓLAS	h u l a s
HÒLAS	h u l a s
HÓLAST	h u l A s t
HÒLAST	h u l A s t
HÓLE	h u l a
HÒLE	h u l a
HÓLEN	h u l @ n
HÒLENE	h u l E n a
HÓLER	h u l @ R
HÒLER	h u l @ R
HÒLET	h u l @ t
HÒLI	h u l i
HOLLANDÉSANE	h O l l A n n e s a n a
HOLLANDÉSAR	h O l l A n n e s a R
HÒLONE	h u l u n a
HÒLOR	h u l u R
HÓLT	h O l t
HÓLTE	h O l t a
HÒP	h u p
HÒPA	h u p A
HÒPANDE	h u p A n n a
HÒPAR	h u p a R
HÒPAS	h u p a s
HÒPAST	h u p A s t
HÒPE	h u p a
HÓV	h u v
HÒV	h u v
HÓVA	h u v A
HÒVA	h u v A
HÓVANE	h u v a n a
HÓVAR	h u v a R
HOVEDÆREN	h u v e d a R @ n
HÓVEN	h u v @ n
HÓVET	h u v @ t
HÒVET	h u v @ t
HÓVI	h u v i
HÒVI	h u v i
HUNDEVÊR	h u n n e v @ R
HUNDEVÊRA	h u n n e v e R A
HUNDEVÊRET	h u n n e v e R @ t
HUNDEVÊRI	h u n n e v e R i
HUNDFÓR	h u n n f u R
HUNDREÅRSJUBILÉ	h u n n R e O R S u b i l e
HUNDREÅRSJUBILÉA	h u n n R e O R S u b i l e A
HUNDREÅRSJUBILÉET	h u n n R e O R S u b i l e @ t
HUNDREÅRSJUBILÉI	h u n n R e O R S u b i l e i
HUSTLERS	h u s t l e R s
HÆL	h E l
HÆLE	h E l a
HÆLES	h E l @ s
HÆLS	h a l s
HÆLT	h a l t
HÆLTS	h a l t s
HÆR	h a R
HÆRENE	h a R E n a
HÆRENES	h a R e n @ s
HÆRMUSÉ	h a R m u s e
HÆRMUSÉA	h a R m u s e A
HÆRMUSÉET	h a R m u s e @ t
HÆRMUSÉI	h a R m u s e i
HÆRNES	h a R n @ s
HÆRS	h a S
HÆSEVÊR	h E s e v @ R
HÆSEVÊRA	h E s e v e R A
HÆSEVÊRET	h E s e v e R @ t
HÆSEVÊRI	h E s e v e R i
HØ	h y
HØAS	h y a s
HØEN	h y @ n
HØENE	h y E n a
HØENES	h y e n @ s
HØENS	h y @ n s
HØER	h y @ R
HØERS	h y a S
HØL	h y l
HØLAND	h y l A n n
HØLANDSVEIEN	h y l A n n s v aI @ n
HØLEN	h y l @ n
HØLENDE	h y l E n n a
HØLENE	h y l E n a
HØLENES	h y l e n @ s
HØLENS	h y l @ n s
HØLER	h y l @ R
HØLERS	h y l a S
HØLKA	h W l k A
HØLKAS	h W l k a s
HØLKE	h W l k a
HØLKENE	h W l k E n a
HØLKENES	h W l k e n @ s
HØLKER	h W l k @ R
HØLKERS	h W l k a S
HØLKES	h W l k @ s
HØLKET	h W l k @ t
HØLKETS	h W l k E t s
HØLS	h W l s
HØLT	h W l t
HØLTE	h W l t a
HØNA	h y n A
HØNAS	h y n a s
HØNE	h y n a
HØNEFÔR	h y n e f u R
HØNEFÔRA	h y n e f u R A
HØNEFÔRET	h y n e f u R @ t
HØNEFÔRI	h y n e f u R i
HØNEN	h y n @ n
HØNENS	h y n @ n s
HØNER	h y n @ R
HØNES	h y n @ s
HØNESS	h y n E s
HØNS	h W n s
HØNSEFÔRI	h W n s e f u R i
HØNSEFRIKASSÉANE	h W n s @ f R i k A s s e a n a
HØNSEFRIKASSÉAR	h W n s @ f R i k A s s e a R
HØR	h y R
HØRER	h y R @ R
HØS	h y s
HØST	h W s t
HØSTS	h W s t s
HØTT	h W t
HØV	h y v
HØVA	h y v A
HØVAS	h y v a s
HØVE	h y v a
HØVE	h y v a
HØVENDE	h y v E n n a
HØVENDES	h y v E n n @ s
HØVENE	h y v E n a
HØVENES	h y v e n @ s
HØVER	h y v @ R
HØVERS	h y v a S
HØVERSTAD	h y v a R S t a d
HØVES	h y v @ s
HØVET	h y v @ t
HØVETS	h y v E t s
HØVIK	h y v i k
HØVING	h y v I N
HØVÅG	h y v o g
HØYVÊR	h y y v @ R
HØYVÊRA	h y y v e R A
HØYVÊRET	h y y v e R @ t
HØYVÊRI	h y y v e R i
IDÉANE	i d e a n a
IDÉAR	i d e a R
IDÉASSOSIASJONANE	i d e A s s u s i A S u n a n a
IDÉASSOSIASJONAR	i d e A s s u s i A S u n a R
IDÉDEBATTANE	i d e d e b A t a n a
IDÉDEBATTAR	i d e d e b A t a R
IDÉDRAMA	i d e d R a m A
IDÉDRAMAET	i d e d R a m a t
IDÉDRAMAI	i d e d R a m A I
IDÉDRAMAA	i d e d R a m o
IDÉDUGNADANE	i d e d u N n a d a n a
IDÉDUGNADAR	i d e d u N n a d a R
IDÉDUGNADEN	i d e d u N n a d @ n
IDÉDUGNADENE	i d e d u N n a d E n a
IDÉDUGNADER	i d e d u N n a d @ R
IDÉENE	i d e E n a
IDÉFLOG	i d e f l u g
IDÉFLOGA	i d e f l u g A
IDÉFLOGET	i d e f l u g @ t
IDÉFLOGI	i d e f l u j i
IDÉFLUKT	i d e f l u k t
IDÉFLUKTA	i d e f l u k t A
IDÉFLUKTENE	i d e f l u k t E n a
IDÉFLUKTER	i d e f l u k t @ R
IDÉFLUKTI	i d e f l u k t i
IDÉGRUNNLAGA	i d e g R u n l a g A
IDÉGRUNNLAGI	i d e g R u n l a j i
IDÉHISTORIONE	i d e h I s t u R i u n a
IDÉHISTORIOR	i d e h I s t u R i u R
IDÉHISTORISKARE	i d e h I s t u R I s k a R a
IDÉHISTORISKAST	i d e h I s t u R I s k A s t
IDÉHISTORISKASTE	i d e h I s t u R I s k A s t a
IDÉKAMP	i d e k A m p
IDÉKAMPANE	i d e k A m p a n a
IDÉKAMPAR	i d e k A m p a R
IDÉKAMPEN	i d e k A m p @ n
IDÉKOMPLEKS	i d e k O m p l E k s
IDÉKOMPLEKSA	i d e k O m p l E k s A
IDÉKOMPLEKSET	i d e k O m p l E k s @ t
IDÉKOMPLEKSI	i d e k O m p l E k s i
IDÉKONKURRANSANE	i d e k O N k u R R A n s a n a
IDÉKONKURRANSAR	i d e k O N k u R R A n s a R
IDÉLAUS	i d e l a w s
IDÉLAUSARE	i d e l a w s a R a
IDÉLAUSAST	i d e l a w s A s t
IDÉLAUSASTE	i d e l a w s A s t a
IDÉLAUSE	i d e l a w s a
IDÉLAUST	i d e l a w s t
IDÉLÆRONE	i d e l a R u n a
IDÉLÆROR	i d e l a R u R
IDÉLØYSA	i d e l y y s A
IDÉLØYSE	i d e l y y s a
IDÉLØYSENE	i d e l y y s E n a
IDÉLØYSER	i d e l y y s @ R
IDÉLØYSONE	i d e l y y s u n a
IDÉLØYSOR	i d e l y y s u R
IDÉMAKAR	i d e m a k a R
IDÉMAKARANE	i d e m a k a R a n a
IDÉMAKARAR	i d e m a k a R a R
IDÉMAKAREN	i d e m a k a R @ n
IDÉPÅVERKNAD	i d e p o v a R k n a d
IDÉPÅVERKNADANE	i d e p o v a R k n a d a n a
IDÉPÅVERKNADAR	i d e p o v a R k n a d a R
IDÉPÅVERKNADEN	i d e p o v a R k n a d @ n
IDÉPÅVERKNADENE	i d e p o v a R k n a d E n a
IDÉPÅVERKNADER	i d e p o v a R k n a d @ R
IDÉRIKARE	i d e R i k a R a
IDÉRIKAST	i d e R i k A s t
IDÉRIKASTE	i d e R i k A s t a
IDÉRIKDOMANE	i d e R I k d u m a n a
IDÉRIKDOMAR	i d e R I k d u m a R
IDÉRIKDOMEN	i d e R I k d u m @ n
IDÉRIKDOMMANE	i d e R I k d O m m a n a
IDÉRIKDOMMAR	i d e R I k d O m m a R
IDÉRIKDOMMEN	i d e R I k d O m m @ n
IDÉRIKT	i d e R I k t
IDÉSFÆRANE	i d e s f a R a n a
IDÉSFÆRAR	i d e s f a R a R
IDÉSFÆRE	i d e s f a R a
IDÉSFÆREN	i d e s f a R @ n
IDÉSKISSONE	i d e S I s s u n a
IDÉSKISSOR	i d e S I s s u R
IDÉSTRAUM	i d e s t R a w m
IDÉSTRAUMANE	i d e s t R a w m a n a
IDÉSTRAUMAR	i d e s t R a w m a R
IDÉSTRAUMEN	i d e s t R a w m @ n
IDÉSTRØM	i d e s t R y m
IDÉSTRØMANE	i d e s t R y m a n a
IDÉSTRØMAR	i d e s t R y m a R
IDÉSTRØMEN	i d e s t R y m @ n
IDÉSYSTEM	i d e s y s t @ m
IDÉSYSTEMA	i d e s y s t e m A
IDÉSYSTEMET	i d e s y s t e m @ t
IDÉSYSTEMI	i d e s y s t e m i
IDÉTEVLING	i d e t @ v l I N
IDÉTEVLINGA	i d e t @ v l I N A
IDÉTEVLINGANE	i d e t @ v l I N a n a
IDÉTEVLINGAR	i d e t @ v l I N a R
IDÉTEVLINGI	i d e t @ v l I N i
IDÉUTVIKLING	i d e u t v I k l I N
INDISKRÉ	I n n I s k R e
INDISKRÉARE	I n n I s k R e a R a
INDISKRÉAST	I n n I s k R e A s t
INDISKRÉASTE	I n n I s k R e A s t a
INDISKRÉE	I n n I s k R e a
INNLÉT	I n l e t
INNLÈT	I n l @ t
INNLØST	I n l W s t
INNLØSTE	I n l W s t a
INNLØSTS	I n l W s t s
ISFÒR	I s f u R
ISFÒRA	I s f u R A
ISFÒRENE	I s f u R E n a
ISFÒRER	I s f u R @ R
ISFÒRI	I s f u R i
JAKTTROFÉ	j A k t R u f e
JAKTTROFÉA	j A k t R u f e A
JAKTTROFÉANE	j A k t R u f e a n a
JAKTTROFÉAR	j A k t R u f e a R
JAKTTROFÉEN	j A k t R u f e @ n
JAKTTROFÉET	j A k t R u f e @ t
JAKTTROFÉI	j A k t R u f e i
JARNBANEKUPÉ	j A R n b a n e k u p e
JARNBANEKUPÉANE	j A R n b a n e k u p e a n a
JARNBANEKUPÉAR	j A R n b a n e k u p e a R
JARNBANEKUPÉEN	j A R n b a n e k u p e @ n
JERNBANEKUPÉANE	j a R n b a n e k u p e a n a
JERNBANEKUPÉAR	j a R n b a n e k u p e a R
JORDBÆRGELÉ	j O R d b a R g e l e
JORDBÆRGELÉANE	j O R d b a R g e l e a n a
JORDBÆRGELÉAR	j O R d b a R g e l e a R
JORDBÆRGELÉEN	j O R d b a R g e l e @ n
JUBILÉI	j u b i l e i
JUSTISKOMITÉANE	j u s t I s k u m i t e a n a
JUSTISKOMITÉAR	j u s t I s k u m i t e a R
JÜRG	j y R g
JÜRGEN	j y R g @ n
JYVÆSKYLÆ	j y v a S y l E
JÆMTLAND	j a m t l A n n
JÆREN	j a R @ n
JØKEL	j y k @ l
JØKELEN	j y k e l @ n
JØKELENS	j y k e l @ n s
JØKELS	j y k E l s
JØKLENE	j W k l E n a
JØKLENES	j W k l e n @ s
JØKLER	j W k l @ R
JØKLERS	j W k l a S
JØNKØPING	j W N k y p I N
JØNSSON	j W n s s u n
JØREN	j y R @ n
JÖRG	j W R g
KAFÉANE	k a f e a n a
KAFÉAR	k a f e a R
KAFÉEIGAR	k a f e aI g a R
KAFÉEIGARANE	k a f e aI g a R a n a
KAFÉEIGARAR	k a f e aI g a R a R
KAFÉEIGAREN	k a f e aI g a R @ n
KAFÉGJEST	k a f e j E s t
KAFÉGJESTANE	k a f e j @ s t a n a
KAFÉGJESTAR	k a f e j @ s t a R
KAFÉGJESTEN	k a f e j E s t @ n
KAFÉGJESTENE	k a f e j @ s t E n a
KAFÉGJESTER	k a f e j E s t @ R
KAFÉLIVA	k a f e l i v A
KAFÉLIVET	k a f e l i v @ t
KAFÉLIVI	k a f e l i v i
KAFÉLOKALA	k a f e l u k a l A
KAFÉLOKALE	k a f e l u k a l a
KAFÉLOKALET	k a f e l u k a l @ t
KAFÉLOKALI	k a f e l u k a l i
KAFÉMAT	k a f e m a t
KAFÉMATANE	k a f e m a t a n a
KAFÉMATAR	k a f e m a t a R
KAFÉMATEN	k a f e m a t @ n
KAFÉVERT	k a f e v a R t
KAFÉVERTANE	k a f e v a R t a n a
KAFÉVERTAR	k a f e v a R t a R
KAFÉVERTEN	k a f e v a R t @ n
KAFÉVERTINNA	k a f e v a R t I n n A
KAFÉVERTINNENE	k a f e v a R t I n n E n a
KAFÉVERTINNER	k a f e v a R t I n n @ R
KAFÉVERTINNONE	k a f e v a R t I n n u n a
KAFÉVERTINNOR	k a f e v a R t I n n u R
KALDVÊR	k A l l v @ R
KALDVÊRA	k A l l v e R A
KALDVÊRET	k A l l v e R @ t
KALDVÊRI	k A l l v e R i
KALVEFRIKASSÉ	k A l v @ f R i k A s s e
KALVEFRIKASSÉANE	k A l v @ f R i k A s s e a n a
KALVEFRIKASSÉAR	k A l v @ f R i k A s s e a R
KALVEFRIKASSÉEN	k A l v @ f R i k A s s e @ n
KAMÉANE	k a m e a n a
KAMÉAR	k a m e a R
KAMÉNÅLANE	k a m e n o l a n a
KAMÉNÅLAR	k a m e n o l a R
KANAPÉANE	k a n a p e a n a
KANAPÉAR	k a n a p e a R
KANINFÔR	k a n I n f u R
KANINFÔRA	k a n I n f u R A
KANINFÔRET	k a n I n f u R @ t
KANINFÔRI	k a n I n f u R i
KARÉT	k a R e t
KARÉTANE	k a R e t a n a
KARÉTAR	k a R e t a R
KARÉTEN	k a R e t @ n
KARRÉANE	k A R R e a n a
KARRÉAR	k A R R e a R
KARRIÉRE	k A R R i e R a
KARRIÉREN	k A R R i e R @ n
KARRIÉRER	k A R R i e R @ R
KASSASUCCÈS	k A s s a s u k @ s
KASSASUCCÈSANE	k A s s a s u k e s a n a
KASSASUCCÈSAR	k A s s a s u k e s a R
KASSASUCCÈSEN	k A s s a s u k e s @ n
KASSESUCCÈS	k A s s e s u k @ s
KASSESUCCÈSANE	k A s s e s u k e s a n a
KASSESUCCÈSAR	k A s s e s u k e s a R
KASSESUCCÈSEN	k A s s e s u k e s @ n
KJÊL	 dZ e l
KJÊLANE	 dZ e l a n a
KJÊLAR	 dZ e l a R
KJÊLARMATUR	 dZ e l A R m a t u R
KJÊLARMATURANE	 dZ e l A R m a t u R a n a
KJÊLARMATURAR	 dZ e l A R m a t u R a R
KJÊLARMATUREN	 dZ e l A R m a t u R @ n
KJÊLBÆR	 dZ E l b a R
KJÊLBÆRA	 dZ E l b a R A
KJÊLBÆRET	 dZ E l b a R @ t
KJÊLBÆRI	 dZ E l b a R i
KJÊLEN	 dZ e l @ n
KJÊLFLIKKAR	 dZ E l f l I k a R
KJÊLFLIKKARANE	 dZ E l f l I k a R a n a
KJÊLFLIKKARAR	 dZ E l f l I k a R a R
KJÊLFLIKKAREN	 dZ E l f l I k a R @ n
KJÊLFORM	 dZ E l f O R m
KJÊLFORMA	 dZ E l f O R m A
KJÊLFORMENE	 dZ E l f O R m E n a
KJÊLFORMER	 dZ E l f O R m @ R
KJÊLFORMI	 dZ E l f O R m i
KJÊLFORMAARE	 dZ E l f O R m o R a
KJÊLFORMAAST	 dZ E l f O R m O s t
KJÊLFORMAASTE	 dZ E l f O R m O s t a
KJÊLHUS	 dZ E l h u s
KJÊLHUSA	 dZ E l h u s A
KJÊLHUSET	 dZ E l h u s @ t
KJÊLHUSI	 dZ E l h u s i
KJÊLJARN	 dZ E j A R n
KJÊLJARNA	 dZ E j A R n A
KJÊLJARNET	 dZ E j A R n @ t
KJÊLJARNI	 dZ E j A R n i
KJÊLJERN	 dZ E j a R n
KJÊLJERNA	 dZ E j a R n A
KJÊLJERNET	 dZ E j a R n @ t
KJÊLJERNI	 dZ E j a R n i
KJÊLOST	 dZ e l w s t
KJÊLOSTANE	 dZ e l w s t a n a
KJÊLOSTAR	 dZ e l w s t a R
KJÊLOSTEN	 dZ e l w s t @ n
KJÊLROM	 dZ E l R u m
KJÊLROMMA	 dZ E l R O m m A
KJÊLROMMET	 dZ E l R O m m @ t
KJÊLROMMI	 dZ E l R O m m i
KJÊLSMED	 dZ E l s m @ d
KJÊLSMEDANE	 dZ E l s m e d a n a
KJÊLSMEDAR	 dZ E l s m e d a R
KJÊLSMEDEN	 dZ E l s m e d @ n
KJÊLSTEIN	 dZ E l s t aI n
KJÊLSTEINANE	 dZ E l s t aI n a n a
KJÊLSTEINAR	 dZ E l s t aI n a R
KJÊLSTEINEN	 dZ E l s t aI n @ n
KJØL	 dZ y l
KJØLE	 dZ y l a
KJØLEN	 dZ y l @ n
KJØLENDE	 dZ y l E n n a
KJØLENDES	 dZ y l E n n @ s
KJØLENS	 dZ y l @ n s
KJØLER	 dZ y l @ R
KJØLES	 dZ y l @ s
KJØLING	 dZ y l I N
KJØLNE	 dZ W l n a
KJØLNES	 dZ W l n @ s
KJØLT	 dZ W l t
KJØLTE	 dZ W l t a
KJØLTES	 dZ W l t @ s
KJØLTS	 dZ W l t s
KJØR	 dZ y R
KJØRE	 dZ y R a
KJØRENDE	 dZ y R E n n a
KJØRENDES	 dZ y R E n n @ s
KJØRER	 dZ y R @ R
KJØRERE	 dZ y R e R a
KJØRERES	 dZ y R e R @ s
KJØRES	 dZ y R @ s
KJØRING	 dZ y R I N
KJØRLAUG	 dZ W R l a w g
KJØRSTAD	 dZ W R S t a d
KJØRT	 dZ W R t
KJØRTE	 dZ W R t a
KJØRTES	 dZ W R t @ s
KJØRTS	 dZ W R t s
KJØRVIK	 dZ W R v i k
KJØS	 dZ y s
KJØTER	 dZ y t @ R
KJØTT	 dZ W t
KLARVÊR	k l A R v @ R
KLARVÊRA	k l A R v e R A
KLARVÊRET	k l A R v e R @ t
KLARVÊRI	k l A R v e R i
KLISJÉANE	k l I S e a n a
KLISJÉAR	k l I S e a R
KLISJÉPREGA	k l I S e p R e g A
KLISJÉPREGAARE	k l I S e p R e g o R a
KLISJÉPREGAAST	k l I S e p R e g O s t
KLISJÉPREGAASTE	k l I S e p R e g O s t a
KLISSVÊR	k l I s s v @ R
KLISSVÊRA	k l I s s v e R A
KLISSVÊRET	k l I s s v e R @ t
KLISSVÊRI	k l I s s v e R i
KLYSSFÔRINGANE	k l y s s f u R I N a n a
KLYSSFÔRINGAR	k l y s s f u R I N a R
KLYSSFÔRINGI	k l y s s f u R I N i
KLÆR	k l a R
KLØ	k l y
KLØDD	k l W d
KLØDDE	k l W d a
KLØDDES	k l W d @ s
KLØDDS	k l W d s
KLØE	k l y a
KLØEN	k l y @ n
KLØENDE	k l y E n n a
KLØENDES	k l y E n n @ s
KLØENS	k l y @ n s
KLØES	k l y @ s
KLØING	k l y I N
KLØR	k l y R
KLØRNE	k l W R n a
KLØRNES	k l W R n @ s
KLØS	k l y s
KLÅRVÊR	k l O R v @ R
KLÅRVÊRA	k l O R v e R A
KLÅRVÊRET	k l O R v e R @ t
KLÅRVÊRI	k l O R v e R i
KNÒD	k n u d
KNÒDA	k n u d A
KNÒDANDE	k n u d A n n a
KNÒDAR	k n u d a R
KNÒDAS	k n u d a s
KNÒDAST	k n u d A s t
KNÒDD	k n O d
KNÒDDE	k n O d a
KNÒDE	k n u d a
KNÒDENE	k n u d E n a
KNÒDER	k n u d @ R
KNÒDONE	k n u d u n a
KNÒDOR	k n u d u R
KNÒDT	k n O d t
KOINÉ	k O I n e
KOINÉANE	k O I n e a n a
KOINÉAR	k O I n e a R
KOINÉEN	k O I n e @ n
KOMITÉANE	k u m i t e a n a
KOMITÉAR	k u m i t e a R
KOMITÉARBEIDA	k u m i t e A R b aI d A
KOMITÉARBEIDI	k u m i t e A R b aI d i
KOMITÉDRØFTING	k u m i t e d R W f t I N
KOMITÉDRØFTINGA	k u m i t e d R W f t I N A
KOMITÉDRØFTINGANE	k u m i t e d R W f t I N a n a
KOMITÉDRØFTINGAR	k u m i t e d R W f t I N a R
KOMITÉDRØFTINGI	k u m i t e d R W f t I N i
KOMITÉEN	k u m i t e @ n
KOMITÉFORMANNEN	k u m i t e f O R m A n n @ n
KOMITÉFORMENN	k u m i t e f O R m E n
KOMITÉFORMENNENE	k u m i t e f O R m E n n E n a
KOMITÉFORMENNER	k u m i t e f O R m E n n @ R
KOMITÉFORSLAG	k u m i t e f O R S l a g
KOMITÉFORSLAGA	k u m i t e f O R S l a g A
KOMITÉFORSLAGET	k u m i t e f O R S l a g @ t
KOMITÉFORSLAGI	k u m i t e f O R S l a j i
KOMITÉFRAMLEGG	k u m i t e f R A m l E g
KOMITÉFRAMLEGGA	k u m i t e f R A m l E g A
KOMITÉFRAMLEGGET	k u m i t e f R A m l E g @ t
KOMITÉFRAMLEGGI	k u m i t e f R A m l E g i
KOMITÉINNSTILLINGANE	k u m i t e I n s t I l l I N a n a
KOMITÉINNSTILLINGAR	k u m i t e I n s t I l l I N a R
KOMITÉINNSTILLINGI	k u m i t e I n s t I l l I N i
KOMITÉMEDLEMANE	k u m i t e m @ d l e m a n a
KOMITÉMEDLEMAR	k u m i t e m @ d l e m a R
KOMITÉMEDLEMEN	k u m i t e m @ d l e m @ n
KOMITÉMEDLEMENE	k u m i t e m @ d l e m E n a
KOMITÉMEDLEMER	k u m i t e m @ d l e m @ R
KOMITÉMEDLEMMANE	k u m i t e m @ d l E m m a n a
KOMITÉMEDLEMMAR	k u m i t e m @ d l E m m a R
KOMITÉMEDLEMMEN	k u m i t e m @ d l E m m @ n
KOMITÉMØTA	k u m i t e m y t A
KOMITÉMØTI	k u m i t e m y t i
KOMITÉTILRÅDING	k u m i t e t I l R o d I N
KOMITÉTILRÅDINGA	k u m i t e t I l R o d I N A
KOMITÉTILRÅDINGANE	k u m i t e t I l R o d I N a n a
KOMITÉTILRÅDINGAR	k u m i t e t I l R o d I N a R
KOMITÉTILRÅDINGI	k u m i t e t I l R o d I N i
KOMMUNIKÉI	k O m m u n i k e i
KOMPOSITTKAPITÉL	k O m p u s I t k a p i t e l
KOMPOSITTKAPITÉLA	k O m p u s I t k a p i t e l A
KOMPOSITTKAPITÉLANE	k O m p u s I t k a p i t e l a n a
KOMPOSITTKAPITÉLAR	k O m p u s I t k a p i t e l a R
KOMPOSITTKAPITÉLI	k O m p u s I t k a p i t e l i
KONSERTTURNÉANE	k O n s a R t u R n e a n a
KONSERTTURNÉAR	k O n s a R t u R n e a R
KONSERTTURNÉEN	k O n s a R t u R n e @ n
KONTROLLKOMITÉANE	k O n t R O l k u m i t e a n a
KONTROLLKOMITÉAR	k O n t R O l k u m i t e a R
KORNBØNDENE	k O R n b W n n E n a
KORNBØNDENES	k O R n b W n n e n @ s
KORYFÉ	k u R y f e
KORYFÉANE	k u R y f e a n a
KORYFÉAR	k u R y f e a R
KORYFÉEN	k u R y f e @ n
KÒS	k u s
KÒSA	k u s A
KÒSI	k u s i
KÒST	k w s t
KÒSTANE	k w s t a n a
KÒSTAR	k w s t a R
KÒSTEN	k w s t @ n
KRAFTFÔRI	k R A f t f u R i
KRÒK	k R u k
KRÒKA	k R u k A
KRÒKANDE	k R u k A n n a
KRÒKAR	k R u k a R
KRÒKAS	k R u k a s
KRÒKAST	k R u k A s t
KRÒKE	k R u k a
KRÒKEN	k R u k @ n
KRÒKENT	k R u k E n t
KRÒKI	k R u dZ i
KRÒKN	k R O k n
KRÒKNA	k R O k n A
KRÒKNANDE	k R O k n A n n a
KRÒKNAR	k R O k n a R
KRÒKNARE	k R O k n a R a
KRÒKNAS	k R O k n a s
KRÒKNAST	k R O k n A s t
KRÒKNASTE	k R O k n A s t a
KRÒKNE	k R O k n a
KRÒP	k R u p
KRÒPA	k R u p A
KRÒPET	k R u p @ t
KRÒPI	k R u p i
KRÜGER	k R y g @ R
KRØKA	k R y k A
KRØKE	k R y k a
KRØKEN	k R y k @ n
KRØKENE	k R y k E n a
KRØKENS	k R y k @ n s
KRØKER	k R y k @ R
KRØKES	k R y k @ s
KRØS	k R y s
KRØS'	k R y s
KRØSENE	k R y s E n a
KRØSENES	k R y s e n @ s
KUFÔRA	k u f u R A
KUFÔRBLANDINGANE	k u f O R b l A n n I N a n a
KUFÔRBLANDINGAR	k u f O R b l A n n I N a R
KUFÔRBLANDINGI	k u f O R b l A n n I N i
KUFÔRET	k u f u R @ t
KUFÔRI	k u f u R i
KUNSTLÊR	k u n s t l @ R
KUNSTLÊRA	k u n s t l e R A
KUNSTLÊRET	k u n s t l e R @ t
KUNSTLÊRI	k u n s t l e R i
KUNSTMUSÉ	k u n s t m u s e
KUNSTMUSÉA	k u n s t m u s e A
KUNSTMUSÉET	k u n s t m u s e @ t
KUNSTMUSÉI	k u n s t m u s e i
KUPÉ	k u p e
KUPÉANE	k u p e a n a
KUPÉAR	k u p e a R
KUPÉMODELL	k u p e m u d E l
KUPÉMODELLANE	k u p e m u d E l l a n a
KUPÉMODELLAR	k u p e m u d E l l a R
KUPÉMODELLEN	k u p e m u d E l l @ n
KUPÉVARMAR	k u p e v A R m a R
KUPÉVARMARANE	k u p e v A R m a R a n a
KUPÉVARMARAR	k u p e v A R m a R a R
KUPÉVARMAREN	k u p e v A R m a R @ n
KUPÉVOGNI	k u p e v O N n i
KVINNESÂL	k v I n n e s a l
KVINNESÂLANE	k v I n n e s a l a n a
KVINNESÂLAR	k v I n n e s a l a R
KVINNESÂLEN	k v I n n e s a l @ n
KVITRÒT	k v I t R u t
KVITRÒTA	k v I t R u t A
KVITRÒTANE	k v I t R u t a n a
KVITRÒTAR	k v I t R u t a R
KVITRÒTE	k v I t R u t a
KVITRÒTEN	k v I t R u t @ n
KVITRÒTET	k v I t R u t @ t
KVITRÒTI	k v I t R u t i
KVÆL	k v E l
KØ	k y
KØDD	k W d
KØDDE	k W d a
KØDDES	k W d @ s
KØDDS	k W d s
KØENDE	k y E n n a
KØENDES	k y E n n @ s
KØGE	k y g a
KÖHLER	k W h l @ R
KØING	k y I N
KØL	k y l
KØS	k y s
KÅPEFÔR	k o p e f u R
KÅPEFÔRA	k o p e f u R A
KÅPEFÔRET	k o p e f u R @ t
KÅPEFÔRI	k o p e f u R i
LAKKLÊR	l A k l @ R
LAKKLÊRA	l A k l e R A
LAKKLÊRET	l A k l e R @ t
LAKKLÊRI	l A k l e R i
LAMÉANE	l a m e a n a
LAMÉAR	l a m e a R
LAMMEFRIKASSÉANE	l A m m @ f R i k A s s e a n a
LAMMEFRIKASSÉAR	l A m m @ f R i k A s s e a R
LÊR	l e R
LÊRA	l e R A
LÊRBALL	l a R b A l
LÊRBALLANE	l a R b A l l a n a
LÊRBALLAR	l a R b A l l a R
LÊRBALLEN	l a R b A l l @ n
LÊRBELTA	l a R b @ l t A
LÊRBELTE	l a R b E l t a
LÊRBELTET	l a R b E l t @ t
LÊRBELTI	l a R b @ l t i
LÊRBRÅK	l a R b R o k
LÊRBRÅKA	l a R b R o k A
LÊRBRÅKENE	l a R b R o k E n a
LÊRBRÅKER	l a R b R o k @ R
LÊRBRÅKI	l a R b R o dZ i
LÊRET	l e R @ t
LÊRHUD	l a R h u d
LÊRHUDA	l a R h u d A
LÊRHUDENE	l a R h u d E n a
LÊRHUDER	l a R h u d @ R
LÊRHUDI	l a R h u d i
LÊRI	l e R i
LÊRJAKKA	l a R j A k A
LÊRJAKKE	l a R j A k a
LÊRJAKKENE	l a R j A k E n a
LÊRJAKKER	l a R j A k @ R
LÊRJAKKONE	l a R j A k u n a
LÊRJAKKOR	l a R j A k u R
LÊRKULA	l a R k u l A
LÊRKULE	l a R k u l a
LÊRKULENE	l a R k u l E n a
LÊRKULER	l a R k u l @ R
LÊRKULONE	l a R k u l u n a
LÊRKULOR	l a R k u l u R
LÊRREIM	l a R R aI m
LÊRREIMA	l a R R aI m A
LÊRREIMANE	l a R R aI m a n a
LÊRREIMAR	l a R R aI m a R
LÊRREIMENE	l a R R aI m E n a
LÊRREIMER	l a R R aI m @ R
LÊRREIMI	l a R R aI m i
LÊRSKO	l a R S k u
LÊRSKOA	l a R S k u A
LÊRSKOEN	l a R S k O a n
LÊRSKOI	l a R S k O I
LÊRSKOR	l a R S k u R
LÊRSKORNE	l a R S k O R n a
LÊRSOLANE	l a R S u l a n a
LÊRSOLAR	l a R S u l a R
LÊRSOLE	l a R S u l a
LÊRSOLEN	l a R S u l @ n
LÊRVARA	l a R v a R A
LÊRVARE	l a R v a R a
LÊRVARENE	l a R v a R E n a
LÊRVARER	l a R v a R @ R
LÊRVARONE	l a R v a R u n a
LÊRVAROR	l a R v a R u R
LÊRVORE	l a R v u R a
LÊRVOREN	l a R v u R @ n
LÊRVORI	l a R v u R i
LÊRVORNARE	l a R v O R n a R a
LÊRVORNAST	l a R v O R n A s t
LÊRVORNASTE	l a R v O R n A s t a
LÊRVORNE	l a R v O R n a
LÉT	l e t
LÈT	l e t
LÉTA	l e t A
LÉTANDE	l e t A n n a
LÉTAR	l e t a R
LÉTAS	l e t a s
LÉTAST	l e t A s t
LÉTE	l e t a
LINDSTRØM	l I n n s t R y m
LINDÖ	l I n n y
LINNVÊR	l I n v @ R
LINNVÊRA	l I n v e R A
LINNVÊRET	l I n v e R @ t
LINNVÊRI	l I n v e R i
LIVRÉI	l I v R e i
LIVRÉKLEDD	l I v R e k l E d
LIVRÉKLEDDARE	l I v R e k l @ d a R a
LIVRÉKLEDDAST	l I v R e k l @ d A s t
LIVRÉKLEDDASTE	l I v R e k l @ d A s t a
LIVRÉKLEDDE	l I v R e k l E d a
LIVRÉKLEDT	l I v R e k l E d t
LÒDE	l u d a
LÒDEN	l u d @ n
LÒDENT	l u d E n t
LÒDI	l u d i
LÒDNARE	l O d n a R a
LÒDNAST	l O d n A s t
LÒDNASTE	l O d n A s t a
LÒDNE	l O d n a
LÒKA	l u k A
LÓKANE	l u k a n a
LÓKAR	l u k a R
LÓKE	l u k a
LÒKE	l u k a
LÓKEN	l u k @ n
LÒKENE	l u k E n a
LÒKER	l u k @ R
LÒKONE	l u k u n a
LÒKOR	l u k u R
LÓS	l u s
LÒS	l u s
LÓSA	l u s A
LÒSA	l u s A
LÓSANDE	l u s A n n a
LÒSANDE	l u s A n n a
LÓSANE	l u s a n a
LÓSAR	l u s a R
LÒSAR	l u s a R
LÓSAS	l u s a s
LÒSAS	l u s a s
LÓSAST	l u s A s t
LÒSAST	l u s A s t
LÓSE	l u s a
LÒSE	l u s a
LÓSEN	l u s @ n
LÓSER	l u s @ R
LÒSER	l u s @ R
LÓSET	l u s @ t
LÒSET	l u s @ t
LÓSI	l u s i
LÒSI	l u s i
LÓST	l w s t
LÒST	l w s t
LÓSTE	l w s t a
LÒSTE	l w s t a
LÒT	l u t
LÒTA	l u t A
LÒTANE	l u t a n a
LÒTAR	l u t a R
LÒTEN	l u t @ n
LÒTET	l u t @ t
LÒTI	l u t i
LÓVANE	l u v a n a
LÓVAR	l u v a R
LÓVE	l u v a
LÓVEN	l u v @ n
LÙT	l u t
LÙTA	l u t A
LÙTANDE	l u t A n n a
LÙTAR	l u t a R
LÙTAS	l u t a s
LÙTAST	l u t A s t
LÙTE	l u t a
LYCÉI	l y k e i
LÆR	l a R
LÆRA	l a R A
LÆRAS	l a R a s
LÆRDAL	l a R d a l
LÆRE	l a R a
LÆRENDE	l a R E n n a
LÆRENDES	l a R E n n @ s
LÆRENE	l a R E n a
LÆRENES	l a R e n @ s
LÆRER	l a R @ R
LÆRES	l a R @ s
LÆRET	l a R @ t
LÆRETS	l a R E t s
LÆRING	l a R I N
LÆRINGA	l a R I N A
LÆRINGAS	l a R I N a s
LÆRINGEN	l a R I N @ n
LÆRINGENS	l a R I N @ n s
LÆRINGS	l a R I N s
LÆRS	l a S
LÆRT	l a R t
LÆRTE	l a R t a
LÆRTES	l a R t @ s
LÆRTS	l a R t s
LÆTA	l E t A
LÆTE	l E t a
LÆTENE	l E t E n a
LÆTENES	l E t e n @ s
LÆTER	l E t @ R
LÆTERS	l E t a S
LÆTES	l E t @ s
LÆVÊR	l E v @ R
LÆVÊRA	l E v e R A
LÆVÊRET	l E v e R @ t
LÆVÊRI	l E v e R i
LØ	l y
LØFVEN	l W f v @ n
LØK	l y k
LØKS	l W k s
LØKT	l W k t
LØKTS	l W k t s
LØNE	l y n a
LØNERE	l y n e R a
LØNERES	l y n e R @ s
LØNES	l y n @ s
LØNT	l W n t
LØNTE	l W n t a
LØNTES	l W n t @ s
LØNTS	l W n t s
LØR	l y R
LØRER	l y R @ R
LØS	l y s
LØS'	l y s
LØSE	l y s a
LØSEN	l y s @ n
LØSENDE	l y s E n n a
LØSENDES	l y s E n n @ s
LØSENS	l y s @ n s
LØSER	l y s @ R
LØSES	l y s @ s
LØSET	l y s @ t
LØSING	l y s I N
LØST	l W s t
LØSTE	l W s t a
LØSTES	l W s t @ s
LØSTS	l W s t s
LØVE	l y v a
LØVEN	l y v @ n
LØVENE	l y v E n a
LØVENES	l y v e n @ s
LØVENS	l y v @ n s
LØVER	l y v @ R
LØVERS	l y v a S
LØVES	l y v @ s
MAKRAMÉA	m A k R a m e A
MAKRAMÉANE	m A k R a m e a n a
MAKRAMÉAR	m A k R a m e a R
MAKRAMÉARBEIDI	m A k R a m e A R b aI d i
MAKRAMÉI	m A k R a m e i
MAKSVÊR	m A k s v @ R
MAKSVÊRA	m A k s v e R A
MAKSVÊRET	m A k s v e R @ t
MAKSVÊRI	m A k s v e R i
MALÌSIØS	m a l i s i y s
MALÌSIØSARE	m a l i s i y s a R a
MALÌSIØSAST	m a l i s i y s A s t
MALÌSIØSASTE	m a l i s i y s A s t a
MALÌSIØSE	m a l i s i y s a
MALÌSIØST	m a l i s i W s t
MALMØ	m A l m y
MARINEATTACHÉANE	m a R i n e A t A S e a n a
MARINEATTACHÉAR	m a R i n e A t A S e a R
MATINÉANE	m a t i n e a n a
MATINÉAR	m a t i n e a R
MAUSOLÉI	m a w s u l e i
MÉD	m e d
MÉDA	m e d A
MÉDANDE	m e d A n n a
MÉDANE	m e d a n a
MÉDAR	m e d a R
MÉDAS	m e d a s
MÉDAST	m e d A s t
MÉDDRAG	m e d R a g
MÉDDRAGA	m e d R a g A
MÉDDRAGET	m e d R a g @ t
MÉDDRAGI	m e d R a j i
MÉDE	m e d a
MÉDEN	m e d @ n
MÉDET	m e d a
MÉDFAR	m e d f a R
MÉDFARA	m e d f a R A
MÉDFARET	m e d f a R @ t
MÉDFARI	m e d f a R i
MÉDI	m e d i
MÉDLINA	m e d l i n A
MÉDLINE	m e d l i n a
MÉDLINENE	m e d l i n E n a
MÉDLINER	m e d l i n @ R
MÉDLINJA	m e d l I n j A
MÉDLINJE	m e d l I n j a
MÉDLINJENE	m e d l I n j E n a
MÉDLINJER	m e d l I n j @ R
MÉDLINJONE	m e d l I n j u n a
MÉDLINJOR	m e d l I n j u R
MÉDLINONE	m e d l i n u n a
MÉDLINOR	m e d l i n u R
MELØ	m e l y
MILDVÊR	m I l l v @ R
MILDVÊRA	m I l l v e R A
MILDVÊRET	m I l l v e R @ t
MILDVÊRI	m I l l v e R i
MILITÆRATTACHÉANE	m i l i t a R A t A S e a n a
MILITÆRATTACHÉAR	m i l i t a R A t A S e a R
MISÉRE	m i s e R a
MISFÓR	m I s f u R
MJØNES	m j y n @ s
MÒ	m u
MÒA	m u A
MOARÉANE	m u a R e a n a
MOARÉAR	m u a R e a R
MÒET	m O a t
MÒI	m O I
MÒL	m u l
MÒLA	m u l A
MÒLANE	m u l a n a
MÒLAR	m u l a R
MÒLEN	m u l @ n
MÒLENE	m u l E n a
MÒLER	m u l @ R
MÒLI	m u l i
MÒR	m u R
MÒRANE	m u R a n a
MÒRAR	m u R a R
MÒREN	m u R @ n
MOSKÉANE	m O s k e a n a
MOSKÉAR	m O s k e a R
MOULINÉGARNI	m u u l i n e g A R n i
MUNNDIARÉANE	m u n d i a R e a n a
MUNNDIARÉAR	m u n d i a R e a R
MUNNLÊR	m u n l @ R
MUNNLÊRA	m u n l e R A
MUNNLÊRET	m u n l e R @ t
MUNNLÊRI	m u n l e R i
MUSÉBYGNING	m u s e b y N n I N
MUSÉBYGNINGANE	m u s e b y N n I N a n a
MUSÉBYGNINGAR	m u s e b y N n I N a R
MUSÉBYGNINGEN	m u s e b y N n I N @ n
MUSÉDIREKTØRANE	m u s e d i R E k t y R a n a
MUSÉDIREKTØRAR	m u s e d i R E k t y R a R
MUSÉGJENSTANDANE	m u s e j @ n s t A n n a n a
MUSÉGJENSTANDAR	m u s e j @ n s t A n n a R
MUSÉI	m u s e i
MÜLLER	m y l l @ R
MÆ	m E
MÆKINEN	m E dZ i n @ n
MÆL	m E l
MÆLA	m E l A
MÆLAS	m E l a s
MÆLE	m E l a
MÆLENDE	m E l E n n a
MÆLENDES	m E l E n n @ s
MÆLENE	m E l E n a
MÆLENES	m E l e n @ s
MÆLER	m E l @ R
MÆLERS	m E l a S
MÆLES	m E l @ s
MÆLET	m E l @ t
MÆLETS	m E l E t s
MÆLING	m E l I N
MÆLINGEN	m E l I N @ n
MÆLINGENE	m E l I N E n a
MÆLINGENES	m E l I N e n @ s
MÆLINGENS	m E l I N @ n s
MÆLINGER	m E l I N @ R
MÆLINGERS	m E l I N a S
MÆLINGS	m E l I N s
MÆLT	m a l t
MÆLTE	m a l t a
MÆLTES	m a l t @ s
MÆLTS	m a l t s
MÄN	m E n
MÆRENE	m a R E n a
MÆSTAD	m a s t a d
MÆT	m E t
MÆTE	m E t a
MÆTENDE	m E t E n n a
MÆTENDES	m E t E n n @ s
MÆTER	m E t @ R
MÆTES	m E t @ s
MÆTING	m E t I N
MÆTTE	m a t a
MØ	m y
MØDREKUPÉANE	m W d R e k u p e a n a
MØDREKUPÉAR	m W d R e k u p e a R
MØKAVÊR	m y k a v @ R
MØKAVÊRA	m y k a v e R A
MØKAVÊRET	m y k a v e R @ t
MØKAVÊRI	m y k a v e R i
MØKKAVÊR	m W k a v @ R
MØKKAVÊRA	m W k a v e R A
MØKKAVÊRET	m W k a v e R @ t
MØKKAVÊRI	m W k a v e R i
MØKKVÊR	m W k v @ R
MØKKVÊRA	m W k v e R A
MØKKVÊRET	m W k v e R @ t
MØKKVÊRI	m W k v e R i
MØKVÊR	m W k v @ R
MØKVÊRA	m W k v e R A
MØKVÊRET	m W k v e R @ t
MØKVÊRI	m W k v e R i
MØL	m y l
MØNE	m y n a
MØNENE	m y n E n a
MØNENES	m y n e n @ s
MØNER	m y n @ R
MØNERS	m y n a S
MØNES	m y n @ s
MØR	m y R
MØRE	m y R a
MØRS	m W S
MØT	m y t
MØTA	m y t A
MØTAS	m y t a s
MØTE	m y t a
MØTENDE	m y t E n n a
MØTENDES	m y t E n n @ s
MØTENE	m y t E n a
MØTENES	m y t e n @ s
MØTER	m y t @ R
MØTERS	m y t a S
MØTES	m y t @ s
MØTET	m y t @ t
MØTETS	m y t E t s
MØTING	m y t I N
MØTS	m W t s
MØTT	m W t
MØTTE	m W t a
MØTTES	m W t @ s
MØTTS	m W t s
NAGLEFÓR	n A g l e f u R
NATTINÉANE	n A t i n e a n a
NATTINÉAR	n A t i n e a R
NATTKAFÉANE	n A t k a f e a n a
NATTKAFÉAR	n A t k a f e a R
NAUDFÔR	n a w d f u R
NAUDFÔRA	n a w d f u R A
NAUDFÔRET	n a w d f u R @ t
NAUDFÔRI	n a w d f u R i
NEDFÔRINGA	n E d f u R I N A
NEDFÔRINGANE	n E d f u R I N a n a
NEDFÔRINGAR	n E d f u R I N a R
NEDFÔRINGI	n E d f u R I N i
NEDLÉT	n E d l e t
NEDLÈT	n E d l @ t
NEGLISJÉANE	n E g l I S e a n a
NEGLISJÉAR	n E g l I S e a R
NIVÅ	n i v o
NORDAVÊR	n O R d a v @ R
NORDAVÊRA	n O R d a v e R A
NORDAVÊRET	n O R d a v e R @ t
NORDAVÊRI	n O R d a v e R i
NORDSTRØM	n O R d s t R y m
NORGESPREMIÉRE	n O R g @ s p R e m i e R a
NORRKØPING	n O R R k y p I N
NÓT	n u t
NÓTA	n u t A
NÓTENE	n u t E n a
NÓTER	n u t @ R
NÓTI	n u t i
NÆR	n a R
NÆS	n E s
NØ	n y
NØDD	n W d
NØDDE	n W d a
NØDDES	n W d @ s
NØDDS	n W d s
NØDE	n y d a
NØDEN	n y d @ n
NØDENS	n y d @ n s
NØDES	n y d @ s
NØDFÔR	n W d f u R
NØDFÔRA	n W d f u R A
NØDFÔRET	n W d f u R @ t
NØDFÔRI	n W d f u R i
NØDIG	n y d I
NØENDE	n y E n n a
NØENDES	n y E n n @ s
NØING	n y I N
NØL	n y l
NØLA	n y l A
NØLAS	n y l a s
NØLEN	n y l @ n
NØLENE	n y l E n a
NØLENES	n y l e n @ s
NØLENS	n y l @ n s
NØLER	n y l @ R
NØLERS	n y l a S
NØR	n y R
NØRBY	n W R b y
NØRE	n y R a
NØRENDE	n y R E n n a
NØRENDES	n y R E n n @ s
NØRER	n y R @ R
NØRES	n y R @ s
NØRING	n y R I N
NØRS	n W S
NØRT	n W R t
NØRTE	n W R t a
NØRTES	n W R t @ s
NØRTS	n W R t s
NØS	n y s
NØSS	n W s
NØVIK	n y v i k
ODYSSÉANE	u d y s s e a n a
ODYSSÉAR	u d y s s e a R
OFSEVÊR	O f s e v @ R
OFSEVÊRA	O f s e v e R A
OFSEVÊRET	O f s e v e R @ t
OFSEVÊRI	O f s e v e R i
OGSÅ	O g s o
OKANE	u k a n a
O´KANE	u k a n a
ÓM	u m
ÓMA	u m A
ÓMANDE	u m A n n a
ÓMAR	u m a R
ÓMAS	u m a s
ÓMAST	u m A s t
ÓME	u m a
OMFÓRS	O m f O S
OMFÓRST	O m f O R S t
OPPFØRINGEN	O p f y R I N @ n
OPPHALDSVÊR	O p h A l l s v @ R
OPPHALDSVÊRA	O p h A l l s v e R A
OPPHALDSVÊRET	O p h A l l s v e R @ t
OPPHALDSVÊRI	O p h A l l s v e R i
ORKIDÉANE	O R dZ i d e a n a
ORKIDÉAR	O R dZ i d e a R
OSTESUFFLÉ	w s t e s u f f l e
OSTESUFFLÉANE	w s t e s u f f l e a n a
OSTESUFFLÉAR	w s t e s u f f l e a R
OSTESUFFLÉEN	w s t e s u f f l e @ n
OVERLÊR	u v a R l @ R
OVERLÊRA	u v a R l e R A
OVERLÊRET	u v a R l e R @ t
OVERLÊRI	u v a R l e R i
OVERLÉT	u v a R l e t
OVERLÈT	u v a R l @ t
PALÉI	p a l e i
PAPPMACHÉ	p A p m A S e
PAPPMACHÉANE	p A p m A S e a n a
PAPPMACHÉAR	p A p m A S e a R
PAPPMACHÉEN	p A p m A S e @ n
PAPPMASJÉANE	p A p m A S e a n a
PAPPMASJÉAR	p A p m A S e a R
PARANÒTTRE	p a R a n O t R a
PARANÒTTREA	p a R a n O t R e A
PARANÒTTREET	p a R a n O t R e @ t
PARANÒTTREI	p a R a n O t R aI
PASSÉARE	p A s s e a R a
PASSÉAST	p A s s e A s t
PASSÉASTE	p A s s e A s t a
PATÉANE	p a t e a n a
PATÉAR	p a t e a R
PEANÒTSMØR	p e a n O t s m y R
PEANÒTSMØRA	p e a n O t s m y R A
PEANÒTSMØRET	p e a n O t s m y R @ t
PEANÒTSMØRI	p e a n O t s m y R i
PERIGÉA	p e R i g e A
PERIGÉET	p e R i g e @ t
PERIGÉI	p e R i g e i
PIKÉANE	p i k e a n a
PIKÉAR	p i k e a R
PLANKOMITÉ	p l A N k u m i t e
PLANKOMITÉANE	p l A N k u m i t e a n a
PLANKOMITÉAR	p l A N k u m i t e a R
PLANKOMITÉEN	p l A N k u m i t e @ n
PLISSÉANE	p l I s s e a n a
PLISSÉAR	p l I s s e a R
PLISSÉSKJØRTI	p l I s s e S W R t i
PLOGFÒR	p l O g f u R
PLOGFÒRA	p l O g f u R A
PLOGFÒRENE	p l O g f u R E n a
PLOGFÒRER	p l O g f u R @ R
PLOGFÒRI	p l O g f u R i
POLÉRMIDDEL	p u l e R m I d @ l
POLÉRMIDDELET	p u l e R m I d e l @ t
POLÉRMIDLA	p u l e R m I d l A
POLÉRMIDLET	p u l e R m I d l @ t
POLÉRMIDLI	p u l e R m I d l i
POPPELALLÉ	p O p e l A l l e
POPPELALLÉANE	p O p e l A l l e a n a
POPPELALLÉAR	p O p e l A l l e a R
POPPELALLÉEN	p O p e l A l l e @ n
PORTEMONÉANE	p w R t e m u n e a n a
PORTEMONÉAR	p w R t e m u n e a R
PORTØREN	p w R t y R @ n
PORTØRENE	p w R t y R E n a
PORTØRENES	p w R t y R e n @ s
PORTØRENS	p w R t y R @ n s
PORTØRER	p w R t y R @ R
PORTØRERS	p w R t y R a S
PÒT	p u t
PÒTA	p u t A
PÒTANDE	p u t A n n a
PÒTAR	p u t a R
PÒTAS	p u t a s
PÒTAST	p u t A s t
PÒTE	p u t a
POTETPURÉANE	p u t @ t p u R e a n a
POTETPURÉAR	p u t @ t p u R e a R
PREMIÈRANE	p R e m i e R a n a
PREMIÈRAR	p R e m i e R a R
PREMIÉRE	p R e m i e R a
PREMIÈREKVELD	p R e m i e R @ k v E l l
PREMIÈREKVELDANE	p R e m i e R @ k v E l l a n a
PREMIÈREKVELDAR	p R e m i e R @ k v E l l a R
PREMIÈREKVELDEN	p R e m i e R @ k v E l l @ n
PREMIÉREN	p R e m i e R @ n
PREMIÈREPUBLIKUM	p R e m i e R e p u b l i k u m
PREMIÈREPUBLIKUMA	p R e m i e R e p u b l i k u m A
PREMIÈREPUBLIKUMET	p R e m i e R e p u b l i k u m @ t
PREMIÈREPUBLIKUMI	p R e m i e R e p u b l i k u m i
PREMIÈREPUBLIKUMMA	p R e m i e R e p u b l i k u m m A
PREMIÈREPUBLIKUMMET	p R e m i e R e p u b l i k u m m @ t
PREMIÈREPUBLIKUMMI	p R e m i e R e p u b l i k u m m i
PRESSEATTACHÉANE	p R E s s e A t A S e a n a
PRESSEATTACHÉAR	p R E s s e A t A S e a R
PRESSFÔRI	p R E s s f u R i
PROBÉRNÅL	p R u b e R n o l
PROBÉRNÅLANE	p R u b e R n o l a n a
PROBÉRNÅLAR	p R u b e R n o l a R
PROBÉRNÅLEN	p R u b e R n o l @ n
PROPYLÉI	p R u p y l e i
PROPYLÉUM	p R u p y l e u m
PROTEGÉANE	p R u t e g e a n a
PROTEGÉAR	p R u t e g e a R
PROTEINFÔR	p R u t aI n f u R
PROTEINFÔRA	p R u t aI n f u R A
PROTEINFÔRET	p R u t aI n f u R @ t
PROTEINFÔRI	p R u t aI n f u R i
PROTESJÉANE	p R u t @ S e a n a
PROTESJÉAR	p R u t @ S e a R
PROTOKOLLKOMITÉANE	p R u t u k O l k u m i t e a n a
PROTOKOLLKOMITÉAR	p R u t u k O l k u m i t e a R
PROVENÇALAR	p R u v @ n k a l a R
PROVENÇALARANE	p R u v @ n k a l a R a n a
PROVENÇALARAR	p R u v @ n k a l a R a R
PROVENÇALAREN	p R u v @ n k a l a R @ n
PUNTLÊR	p u n t l @ R
PUNTLÊRA	p u n t l e R A
PUNTLÊRET	p u n t l e R @ t
PUNTLÊRI	p u n t l e R i
PUNTLÊRSMAGANE	p u n t l a R S m a g a n a
PUNTLÊRSMAGAR	p u n t l a R S m a g a R
PUNTLÊRSMAGE	p u n t l a R S m a g a
PUNTLÊRSMAGEN	p u n t l a R S m a g @ n
PURÉANE	p u R e a n a
PURÉAR	p u R e a R
PYGMÉANE	p y g m e a n a
PYGMÉAR	p y g m e a R
PYGMÉISK	p y g m e I s k
PYGMÉISKARE	p y g m e I s k a R a
PYGMÉISKAST	p y g m e I s k A s t
PYGMÉISKASTE	p y g m e I s k A s t a
PYGMÉISKE	p y g m e I s k a
PYGMÉSTAMMA	p y g m e s t A m m A
PYGMÉSTAMMANE	p y g m e s t A m m a n a
PYGMÉSTAMMAR	p y g m e s t A m m a R
PYGMÉSTAMME	p y g m e s t A m m a
PYGMÉSTAMMEN	p y g m e s t A m m @ n
PYGMÉSTAMMENE	p y g m e s t A m m E n a
PYGMÉSTAMMER	p y g m e s t A m m @ R
PYGMÉSTAMMONE	p y g m e s t A m m u n a
PYGMÉSTAMMOR	p y g m e s t A m m u R
PYORÉANE	p y u R e a n a
PYORÉAR	p y u R e a R
PYTAGORÉISK	p y t a g u R e I s k
PYTAGORÉISKARE	p y t a g u R e I s k a R a
PYTAGORÉISKAST	p y t a g u R e I s k A s t
PYTAGORÉISKASTE	p y t a g u R e I s k A s t a
PYTAGORÉISKE	p y t a g u R e I s k a
PÆLA	p E l A
PÆLE	p E l a
PÆLEN	p E l @ n
PÆLENE	p E l E n a
PÆLENES	p E l e n @ s
PÆLENS	p E l @ n s
PÆLER	p E l @ R
PÆLERS	p E l a S
PÆLES	p E l @ s
PØL	p y l
PØLEN	p y l @ n
PØLENE	p y l E n a
PØLENES	p y l e n @ s
PØLENS	p y l @ n s
PØLER	p y l @ R
PØLERS	p y l a S
PØLS	p W l s
PØSE	p y s a
PØSER	p y s @ R
PØSES	p y s @ s
PÅ	p o
PÅFUGLFJØR	p o f u g l f j y R
PÅFUGLFJØRA	p o f u g l f j y R A
PÅFUGLFJØRAS	p o f u g l f j y R a s
PÅFUGLFJØREN	p o f u g l f j y R @ n
PÅFUGLFJØRENE	p o f u g l f j y R E n a
PÅFUGLFJØRENES	p o f u g l f j y R e n @ s
PÅFUGLFJØRENS	p o f u g l f j y R @ n s
PÅFUGLFJØRER	p o f u g l f j y R @ R
PÅFUGLFJØRERS	p o f u g l f j y R a S
PÅFUGLFJØRS	p o f u g l f j W S
PÅKJØR	p O dZ y R
PÅKJØRE	p O dZ y R a
PÅKJØRENDE	p O dZ y R E n n a
PÅKJØRENDES	p O dZ y R E n n @ s
PÅKJØRER	p O dZ y R @ R
PÅKJØRES	p O dZ y R @ s
PÅKJØRING	p O dZ y R I N
PÅKJØRT	p O dZ W R t
PÅKJØRTE	p O dZ W R t a
PÅKJØRTES	p O dZ W R t @ s
PÅKJØRTS	p O dZ W R t s
RASVÊR	R A s v @ R
RASVÊRA	R A s v e R A
RASVÊRET	R A s v e R @ t
RASVÊRI	R A s v e R i
REDAKSJONSKOMITÉANE	R e d A k S O n s k u m i t e a n a
REDAKSJONSKOMITÉAR	R e d A k S O n s k u m i t e a R
REGNVÊR	R E N n v @ R
REGNVÊRA	R E N n v e R A
REGNVÊRET	R E N n v e R @ t
REGNVÊRI	R E N n v e R i
RELÉI	R e l e i
RELÉSTASJONANE	R e l e s t A S u n a n a
RELÉSTASJONAR	R e l e s t A S u n a R
RENÉ	R e n e
RENOMMÉI	R e n O m m e i
RESYMÉI	R e s y m e i
RISSEFJØR	R I s s @ f j y R
RISSEFJØRA	R I s s @ f j y R A
RISSEFJØRAS	R I s s @ f j y R a s
RISSEFJØREN	R I s s @ f j y R @ n
RISSEFJØRENE	R I s s @ f j y R E n a
RISSEFJØRENES	R I s s @ f j y R e n @ s
RISSEFJØRENS	R I s s @ f j y R @ n s
RISSEFJØRER	R I s s @ f j y R @ R
RISSEFJØRERS	R I s s @ f j y R a S
RISSEFJØRS	R I s s @ f j W S
RÒD	R u d
RÒDA	R u d A
RÒDANE	R u d a n a
RÒDAR	R u d a R
RÒDE	R u d a
RÒDEN	R u d @ n
RÒDET	R u d a
RÒDI	R u d i
RÒK	R u k
RÒKA	R u k A
RÒKANE	R u k a n a
RÒKAR	R u k a R
RÒKE	R u k a
RÒKEN	R u k @ n
RÒKET	R u k @ t
RÒKI	R u dZ i
RÒKMÅL	R O k m o l
RÒKMÅLA	R O k m o l A
RÒKMÅLET	R O k m o l @ t
RÒKMÅLI	R O k m o l i
RÒKAARE	R u k o R a
RÒKAAST	R u k O s t
RÒKAASTE	R u k O s t a
RÒS	R u s
RÒSA	R u s A
RÒSANDE	R u s A n n a
RÒSAR	R u s a R
RÒSAS	R u s a s
RÒSAST	R u s A s t
RÒSE	R u s a
RÒSENE	R u s E n a
RÒSER	R u s @ R
RÒSET	R u s @ t
RÒSETARE	R u s e t a R a
RÒSETAST	R u s e t A s t
RÒSETASTE	R u s e t A s t a
RÒSETE	R u s e t a
RÒSETEARE	R u s e t e a R a
RÒSETEAST	R u s e t e A s t
RÒSETEASTE	R u s e t e A s t a
ROSÉVINANE	R u s e v i n a n a
ROSÉVINAR	R u s e v i n a R
RÒSI	R u s i
RÒSONE	R u s u n a
RÒSOR	R u s u R
RÒSUT	R u s u t
RÒSUTARE	R u s u t a R a
RÒSUTAST	R u s u t A s t
RÒSUTASTE	R u s u t A s t a
RÒSUTE	R u s u t a
RÒT	R u t
RÒTA	R u t A
RÒTANE	R u t a n a
RÒTAR	R u t a R
RÒTE	R u t a
RÒTEN	R u t @ n
RÒTENSKAP	R u t @ n s k a p
RÒTENSKAPANE	R u t @ n s k a p a n a
RÒTENSKAPAR	R u t @ n s k a p a R
RÒTENSKAPEN	R u t @ n s k a p @ n
RÒTENT	R u t E n t
RÒTET	R u t @ t
RÒTI	R u t i
RÒTNARE	R O t n a R a
RÒTNAST	R O t n A s t
RÒTNASTE	R O t n A s t a
RÒTNE	R O t n a
RÙNANE	R u n a n a
RÙNAR	R u n a R
RÙNE	R u n a
RÙNEN	R u n @ n
RUSKEVÊR	R u s k e v @ R
RUSKEVÊRA	R u s k e v e R A
RUSKEVÊRET	R u s k e v e R @ t
RUSKEVÊRI	R u s k e v e R i
RUSSLÊR	R u s s l @ R
RUSSLÊRA	R u s s l e R A
RUSSLÊRET	R u s s l e R @ t
RUSSLÊRI	R u s s l e R i
RÆ	R E
RÆR	R a R
RØD	R y d
RØDA	R y d A
RØDAL	R y d a l
RØDAS	R y d a s
RØDD	R W d
RØDDE	R W d a
RØDDES	R W d @ s
RØDDS	R W d s
RØDE	R y d a
RØDEN	R y d @ n
RØDENDE	R y d E n n a
RØDENDES	R y d E n n @ s
RØDENE	R y d E n a
RØDENES	R y d e n @ s
RØDENS	R y d @ n s
RØDER	R y d @ R
RØDERS	R y d a S
RØDES	R y d @ s
RØDING	R y d I N
RØDS	R W d s
RØEN	R y @ n
RØK	R y k
RØKE	R y k a
RØKEN	R y k @ n
RØKENDE	R y k E n n a
RØKENDES	R y k E n n @ s
RØKENE	R y k E n a
RØKENES	R y k e n @ s
RØKENS	R y k @ n s
RØKER	R y k @ R
RØKERS	R y k a S
RØKES	R y k @ s
RØKET	R y k @ t
RØKETE	R y k e t a
RØKETES	R y k e t @ s
RØKETS	R y k E t s
RØKING	R y dZ I N
RØKS	R W k s
RØKT	R W k t
RØKTE	R W k t a
RØKTES	R W k t @ s
RØKTS	R W k t s
RØL	R y l
RØLE	R y l a
RØLENDE	R y l E n n a
RØLENDES	R y l E n n @ s
RØLER	R y l @ R
RØLES	R y l @ s
RØLING	R y l I N
RØLT	R W l t
RØLTE	R W l t a
RØLTES	R W l t @ s
RØLTS	R W l t s
RØR	R y R
RØRNE	R W R n a
RØRNES	R W R n @ s
RØRS	R W S
RØSKE	R W s k a
RØSKES	R W s k @ s
RÖSNES	R W s n @ s
RØSTAD	R W s t a d
RØSTADVEIEN	R W s t A d v aI @ n
RØTER	R y t @ R
RØV	R y v
RØVA	R y v A
RØVAS	R y v a s
RØVER	R y v @ R
RØVERS	R y v a S
RØYKEKUPÉANE	R y y k e k u p e a n a
RØYKEKUPÉAR	R y y k e k u p e a R
RØYKJEKUPÉ	R y y dZ e k u p e
RØYKJEKUPÉANE	R y y dZ e k u p e a n a
RØYKJEKUPÉAR	R y y dZ e k u p e a R
RØYKJEKUPÉEN	R y y dZ e k u p e @ n
RØYTEVÊR	R y y t e v @ R
RØYTEVÊRA	R y y t e v e R A
RØYTEVÊRET	R y y t e v e R @ t
RØYTEVÊRI	R y y t e v e R i
RÅVÊR	R o v @ R
RÅVÊRA	R o v e R A
RÅVÊRET	R o v e R @ t
RÅVÊRI	R o v e R i
SALONGFÄHIGARE	s a l O N f E h i g a R a
SALONGFÄHIGAST	s a l O N f E h i g A s t
SALONGFÄHIGASTE	s a l O N f E h i g A s t a
SAMFÓRS	s A m f O S
SAMFÓRST	s A m f O R S t
SANDØ	s A n n y
SAUMFÓR	s a w m f u R
SAUTÉANE	s a w t e a n a
SAUTÉAR	s a w t e a R
SCHÆFER	S E f @ R
SCHÆFEREN	S E f e R @ n
SCHØNBERG	S W n b a R g
SÉG	s e g
SEKSÆRING	s E k s a R I N
SEKSÆRINGEN	s E k s a R I N @ n
SEKSÆRINGENE	s E k s a R I N E n a
SEKSÆRINGENES	s E k s a R I N e n @ s
SEKSÆRINGENS	s E k s a R I N @ n s
SEKSÆRINGER	s E k s a R I N @ R
SEKSÆRINGERS	s E k s a R I N a S
SEKSÆRINGS	s E k s a R I N s
SEMSKLÊR	s E m s k l @ R
SEMSKLÊRA	s E m s k l e R A
SEMSKLÊRET	s E m s k l e R @ t
SEMSKLÊRI	s E m s k l e R i
SEMSLÊR	s E m S l @ R
SEMSLÊRA	s E m S l e R A
SEMSLÊRET	s E m S l e R @ t
SEMSLÊRI	s E m S l e R i
SENTRALKOMITÉANE	s E n t R A l k u m i t e a n a
SENTRALKOMITÉAR	s E n t R A l k u m i t e a R
!SIL	u t R u p s t E N n s i l
SILOFÔRI	s i l u f u R i
SJETÉANE	S e t e a n a
SJETÉAR	S e t e a R
SJÆL	S E l
SJØ	S y
SJØENE	S y E n a
SJØENES	S y e n @ s
SJØGREN	S W g R @ n
SJØS	S y s
SJØVÊR	S y v @ R
SJØVÊRA	S y v e R A
SJØVÊRET	S y v e R @ t
SJØVÊRI	S y v e R i
SJØVIK	S y v i k
SKADEVÊR	s k a d e v @ R
SKADEVÊRA	s k a d e v e R A
SKADEVÊRET	s k a d e v e R @ t
SKADEVÊRI	s k a d e v e R i
SKAMFÓR	s k A m f u R
SKARABÉANE	s k a R a b e a n a
SKARABÉAR	s k a R a b e a R
SKINVÊR	S I n v @ R
SKINVÊRA	S I n v e R A
SKINVÊRET	S I n v e R @ t
SKINVÊRI	S I n v e R i
SKJØR	S y R
SKJØRE	S y R a
SKJØRENE	S y R E n a
SKJØRERE	S y R e R a
SKJØRERES	S y R e R @ s
SKJØRES	S y R @ s
SKJØREST	S y R E s t
SKJØRESTE	S y R E s t a
SKJØRESTES	S y R E s t @ s
SKJØRESTS	S y R E s t s
SKJØRET	S y R @ t
SKJØRN	S W R n
SKJØRNA	S W R n A
SKJØRNAS	S W R n a s
SKJØRNE	S W R n a
SKJØRNENDE	S W R n E n n a
SKJØRNENDES	S W R n E n n @ s
SKJØRNER	S W R n @ R
SKJØRNES	S W R n @ s
SKJØRNET	S W R n @ t
SKJØRNETE	S W R n e t a
SKJØRNETES	S W R n e t @ s
SKJØRNETS	S W R n E t s
SKJØRNING	S W R n I N
SKJØRS	S W S
SKJØRT	S W R t
SKJØRTS	S W R t s
SKÒL	s k u l
SKÒLA	s k u l A
SKÒLANDE	s k u l A n n a
SKÒLAR	s k u l a R
SKÒLAS	s k u l a s
SKÒLAST	s k u l A s t
SKÒLE	s k u l a
SKÒLET	s k u l @ t
SKÒLI	s k u l i
SKÒLREGN	s k O l R E N n
SKÒLREGNA	s k O l R @ N n A
SKÒLREGNANDE	s k O l R @ N n A n n a
SKÒLREGNAR	s k O l R @ N n a R
SKÒLREGNAS	s k O l R @ N n a s
SKÒLREGNAST	s k O l R @ N n A s t
SKÒLREGND	s k O l R E N n n
SKÒLREGNDE	s k O l R E N n n a
SKÒLREGNE	s k O l R E N n a
SKÒLREGNER	s k O l R E N n @ R
SKÒLREGNT	s k O l R E N n t
SKÒLREGNTE	s k O l R E N n t a
SKÒR	s k u R
SKÒRA	s k u R A
SKÒRANDE	s k u R A n n a
SKÒRAR	s k u R a R
SKÒRAS	s k u R a s
SKÒRAST	s k u R A s t
SKÒRE	s k u R a
SKÒRENE	s k u R E n a
SKÒRER	s k u R @ R
SKÒRI	s k u R i
SKÒRONE	s k u R u n a
SKÒROR	s k u R u R
SKRÆLING	s k R E l I N
SKRÆR	s k R a R
SKRØ	s k R y
SKRØDD	s k R W d
SKRØDDE	s k R W d a
SKRØDDES	s k R W d @ s
SKRØDDS	s k R W d s
SKRØEN	s k R y @ n
SKRØENDE	s k R y E n n a
SKRØENDES	s k R y E n n @ s
SKRØENS	s k R y @ n s
SKRØING	s k R y I N
SKRØN	s k R y n
SKRØNA	s k R y n A
SKRØNAS	s k R y n a s
SKRØNE	s k R y n a
SKRØNENDE	s k R y n E n n a
SKRØNENDES	s k R y n E n n @ s
SKRØNER	s k R y n @ R
SKRØNES	s k R y n @ s
SKRØNING	s k R y n I N
SKRØNT	s k R W n t
SKRØNTE	s k R W n t a
SKRØNTES	s k R W n t @ s
SKRØNTS	s k R W n t s
SKRØR	s k R y R
SKRØS	s k R y s
SKVETTLÊR	s k v E t l @ R
SKVETTLÊRA	s k v E t l e R A
SKVETTLÊRET	s k v E t l e R @ t
SKVETTLÊRI	s k v E t l e R i
SKÅLVIK	s k O l v i k
SLØA	S l y A
SLØAS	S l y a s
SLØEN	S l y @ n
SLØENE	S l y E n a
SLØENES	S l y e n @ s
SLØENS	S l y @ n s
SLØER	S l y @ R
SLØERS	S l y a S
SLØES	S l y @ s
SLØR	S l y R
SLØS	S l y s
SLØTTVEIEN	S l W t v aI @ n
SLÅTTEVÊR	S l O t e v @ R
SLÅTTEVÊRA	S l O t e v e R A
SLÅTTEVÊRET	S l O t e v e R @ t
SLÅTTEVÊRI	S l O t e v e R i
SMURNINGSLÊR	s m u R n I N S l @ R
SMURNINGSLÊRA	s m u R n I N S l e R A
SMURNINGSLÊRET	s m u R n I N S l e R @ t
SMURNINGSLÊRI	s m u R n I N S l e R i
SMØ	s m y
SMÅVÊR	s m o v @ R
SMÅVÊRA	s m o v e R A
SMÅVÊRET	s m o v e R @ t
SMÅVÊRI	s m o v e R i
SNARKAFÉ	s n A R k a f e
SNARKAFÉANE	s n A R k a f e a n a
SNARKAFÉAR	s n A R k a f e a R
SNARKAFÉEN	s n A R k a f e @ n
SNÒR	s n u R
SNÒRA	s n u R A
SNÒRET	s n u R @ t
SNÒRETARE	s n u R e t a R a
SNÒRETAST	s n u R e t A s t
SNÒRETASTE	s n u R e t A s t a
SNÒRETE	s n u R e t a
SNÒRETEARE	s n u R e t e a R a
SNÒRETEAST	s n u R e t e A s t
SNÒRETEASTE	s n u R e t e A s t a
SNÒRI	s n u R i
SNÒRKLYSA	s n O R k l y s A
SNÒRKLYSE	s n O R k l y s a
SNÒRKLYSENE	s n O R k l y s E n a
SNÒRKLYSER	s n O R k l y s @ R
SNÒRKLYSONE	s n O R k l y s u n a
SNÒRKLYSOR	s n O R k l y s u R
SNÒRLUR	s n O R l u R
SNÒRLURANE	s n O R l u R a n a
SNÒRLURAR	s n O R l u R a R
SNÒRLUREN	s n O R l u R @ n
SNÒRUNGANE	s n u R u N a n a
SNÒRUNGAR	s n u R u N a R
SNÒRUNGE	s n u R u N a
SNÒRUNGEN	s n u R u N @ n
SNÒRUT	s n u R u t
SNÒRUTARE	s n u R u t a R a
SNÒRUTAST	s n u R u t A s t
SNÒRUTASTE	s n u R u t A s t a
SNÒRUTE	s n u R u t a
SNURPEFLÒTANE	s n u R p @ f l u t a n a
SNURPEFLÒTAR	s n u R p @ f l u t a R
SNURPEFLÒTE	s n u R p @ f l u t a
SNURPEFLÒTEN	s n u R p @ f l u t @ n
SNØVÊR	s n y v @ R
SNØVÊRA	s n y v e R A
SNØVÊRET	s n y v e R @ t
SNØVÊRI	s n y v e R i
SOARÉANE	s u a R e a n a
SOARÉAR	s u a R e a R
SOLELÊR	s u l e l @ R
SOLELÊRA	s u l e l e R A
SOLELÊRET	s u l e l e R @ t
SOLELÊRI	s u l e l e R i
SOLIDARITETSKOMITÉ	s u l i d a R i t E t s k u m i t e
SOLIDARITETSKOMITÉANE	s u l i d a R i t E t s k u m i t e a n a
SOLIDARITETSKOMITÉAR	s u l i d a R i t E t s k u m i t e a R
SOLIDARITETSKOMITÉEN	s u l i d a R i t E t s k u m i t e @ n
SOLOKARRIÉRE	s u l u k A R R i e R a
SOLSKINSVÊR	s O l S I n s v @ R
SOLSKINSVÊRA	s O l S I n s v e R A
SOLSKINSVÊRET	s O l S I n s v e R @ t
SOLSKINSVÊRI	s O l S I n s v e R i
SORBÉ	s O R b e
SORBÉANE	s O R b e a n a
SORBÉAR	s O R b e a R
SORBÉEN	s O R b e @ n
SOVEKUPÉANE	s u v e k u p e a n a
SOVEKUPÉAR	s u v e k u p e a R
SPINNMÒL	s p I n m u l
SPINNMÒLANE	s p I n m u l a n a
SPINNMÒLAR	s p I n m u l a R
SPINNMÒLEN	s p I n m u l @ n
SPIRALFJØR	s p i R A l f j y R
SPIRALFJØRA	s p i R A l f j y R A
SPIRALFJØRAS	s p i R A l f j y R a s
SPIRALFJØREN	s p i R A l f j y R @ n
SPIRALFJØRENE	s p i R A l f j y R E n a
SPIRALFJØRENES	s p i R A l f j y R e n @ s
SPIRALFJØRENS	s p i R A l f j y R @ n s
SPIRALFJØRER	s p i R A l f j y R @ R
SPIRALFJØRERS	s p i R A l f j y R a S
SPIRALFJØRS	s p i R A l f j W S
SPONDÉANE	s p w n n e a n a
SPONDÉAR	s p w n n e a R
SPRINGFJØR	s p R I N f j y R
SPRINGFJØRA	s p R I N f j y R A
SPRINGFJØRAS	s p R I N f j y R a s
SPRINGFJØREN	s p R I N f j y R @ n
SPRINGFJØRENE	s p R I N f j y R E n a
SPRINGFJØRENES	s p R I N f j y R e n @ s
SPRINGFJØRENS	s p R I N f j y R @ n s
SPRINGFJØRS	s p R I N f j W S
SPRÒKA	s p R u k A
SPRÒKE	s p R u k a
SPRÒKENE	s p R u k E n a
SPRÒKER	s p R u k @ R
SPRÒKONE	s p R u k u n a
SPRÒKOR	s p R u k u R
SPØK	s p y k
SPØR	s p y R
STAMKAFÉANE	s t A m k a f e a n a
STAMKAFÉAR	s t A m k a f e a R
STEMPELFJØR	s t E m p @ l f j y R
STEMPELFJØRA	s t E m p @ l f j y R A
STEMPELFJØRAS	s t E m p @ l f j y R a s
STEMPELFJØREN	s t E m p @ l f j y R @ n
STEMPELFJØRENE	s t E m p @ l f j y R E n a
STEMPELFJØRENES	s t E m p @ l f j y R e n @ s
STEMPELFJØRENS	s t E m p @ l f j y R @ n s
STEMPELFJØRER	s t E m p @ l f j y R @ R
STEMPELFJØRERS	s t E m p @ l f j y R a S
STEMPELFJØRS	s t E m p @ l f j W S
STORTINGSKOMITÉANE	s t w R t I N s k u m i t e a n a
STORTINGSKOMITÉAR	s t w R t I N s k u m i t e a R
STORØ	s t u R y
STÒT	s t u t
STÒTA	s t u t A
STÒTANDE	s t u t A n n a
STÒTAR	s t u t a R
STÒTAS	s t u t a s
STÒTAST	s t u t A s t
STÒTE	s t u t a
STRØ	s t R y
STRØMSHOLM	s t R W m s h O l m
STRØMSTAD	s t R W m s t a d
STRØS	s t R y s
STRÅFÔRI	s t R o f u R i
STYGGEVÊR	s t y g e v @ R
STYGGEVÊRA	s t y g e v e R A
STYGGEVÊRET	s t y g e v e R @ t
STYGGEVÊRI	s t y g e v e R i
STYGGVÊR	s t y g v @ R
STYGGVÊRA	s t y g v e R A
STYGGVÊRET	s t y g v e R @ t
STYGGVÊRI	s t y g v e R i
STYREFJØR	s t y R @ f j y R
STYREFJØRA	s t y R @ f j y R A
STYREFJØRAS	s t y R @ f j y R a s
STYREFJØREN	s t y R @ f j y R @ n
STYREFJØRENE	s t y R @ f j y R E n a
STYREFJØRENES	s t y R @ f j y R e n @ s
STYREFJØRENS	s t y R @ f j y R @ n s
STYREFJØRS	s t y R @ f j W S
STÆR	s t a R
STØ	s t y
STØEN	s t y @ n
STØENDE	s t y E n n a
STØENDES	s t y E n n @ s
STØES	s t y @ s
STØING	s t y I N
STØL	s t y l
STØLA	s t y l A
STØLAS	s t y l a s
STØLE	s t y l a
STØLENE	s t y l E n a
STØLENES	s t y l e n @ s
STØLER	s t y l @ R
STØLERS	s t y l a S
STØLET	s t y l @ t
STØLETE	s t y l e t a
STØLETES	s t y l e t @ s
STØLETS	s t y l E t s
STØLNE	s t W l n a
STØLS	s t W l s
STØR	s t y R
STØREN	s t y R @ n
STØRENE	s t y R E n a
STØRENES	s t y R e n @ s
STØRENS	s t y R @ n s
STØRER	s t y R @ R
STØRERS	s t y R a S
STØRK	s t W R k
STØRS	s t W S
STØTT	s t W t
STØTTE	s t W t a
STØTTES	s t W t @ s
STØTTS	s t W t s
STÅLFJØR	s t O l f j y R
STÅLFJØRA	s t O l f j y R A
STÅLFJØRAS	s t O l f j y R a s
STÅLFJØREN	s t O l f j y R @ n
STÅLFJØRENE	s t O l f j y R E n a
STÅLFJØRENES	s t O l f j y R e n @ s
STÅLFJØRENS	s t O l f j y R @ n s
STÅLFJØRER	s t O l f j y R @ R
STÅLFJØRERS	s t O l f j y R a S
STÅLFJØRS	s t O l f j W S
SUCCÈSANE	s u k e s a n a
SUCCÈSAR	s u k e s a R
SUFFLÉANE	s u f f l e a n a
SUFFLÉAR	s u f f l e a R
SUNDFØR	s u n n f y R
SUPÉANE	s u p e a n a
SUPÉAR	s u p e a R
SURFÔRI	s u R f u R i
SURVÊR	s u R v @ R
SURVÊRA	s u R v e R A
SURVÊRET	s u R v e R @ t
SURVÊRI	s u R v e R i
SUSLEVÊR	s u s l e v @ R
SUSLEVÊRA	s u s l e v e R A
SUSLEVÊRET	s u s l e v e R @ t
SUSLEVÊRI	s u s l e v e R i
SUTLEVÊR	s u t l e v @ R
SUTLEVÊRA	s u t l e v e R A
SUTLEVÊRET	s u t l e v e R @ t
SUTLEVÊRI	s u t l e v e R i
SVELTEFÔR	s v E l t e f u R
SVELTEFÔRA	s v E l t e f u R A
SVELTEFÔRANDE	s v E l t e f u R A n n a
SVELTEFÔRAR	s v E l t e f u R a R
SVELTEFÔRAS	s v E l t e f u R a s
SVELTEFÔRAST	s v E l t e f u R A s t
SVELTEFÔRE	s v E l t e f u R a
SVINELÊR	s v i n e l @ R
SVINELÊRA	s v i n e l e R A
SVINELÊRET	s v i n e l e R @ t
SVINELÊRI	s v i n e l e R i
SWEDENS	s v e d e n s
SYLTEFÔRI	s y l t e f u R i
SÆL	s E l
SÆLA	s E l A
SÆLD	s a l l
SÆLDA	s a l l A
SÆLDAS	s a l l a s
SÆLDE	s a l l a
SÆLDENDE	s a l l E n n a
SÆLDENDES	s a l l E n n @ s
SÆLDER	s a l l @ R
SÆLDES	s a l l @ s
SÆLDET	s a l l @ t
SÆLDETE	s a l l e t a
SÆLDETES	s a l l e t @ s
SÆLDETS	s a l l E t s
SÆLDING	s a l l I N
SÆLE	s E l a
SÆLENE	s E l E n a
SÆLER	s E l @ R
SÆLES	s E l @ s
SÆLS	s a l s
SÆLT	s a l t
SÆLTS	s a l t s
SÆMUND	s E m u n n
SÆR	s a R
SÆRBEHANDLING	s a R b e h A n n l I N
SÆRE	s a R a
SÆRERE	s a R e R a
SÆRERES	s a R e R @ s
SÆRES	s a R @ s
SÆREST	s a R E s t
SÆRESTE	s a R E s t a
SÆRESTES	s a R E s t @ s
SÆRESTS	s a R E s t s
SÆRHET	s a R h @ t
SÆRHETEN	s a R h e t @ n
SÆRMERKER	s a R m a R k @ R
SÆRS	s a S
SÆRT	s a R t
SÆRTS	s a R t s
SÆT	s E t
SÆTA	s E t A
SÆTE	s E t a
SÆTENDE	s E t E n n a
SÆTENDES	s E t E n n @ s
SÆTER	s E t @ R
SÆTERS	s E t a S
SÆTES	s E t @ s
SÆTET	s E t @ t
SÆTETE	s E t e t a
SÆTING	s E t I N
SØBY	s y b y
SØDERBERG	s y d a R b a R g
SØL	s y l
SØLA	s y l A
SØLAND	s y l A n n
SØLDEN	s W l l @ n
SØLE	s y l a
SØLEN	s y l @ n
SØLENDE	s y l E n n a
SØLENDES	s y l E n n @ s
SØLER	s y l @ R
SØLES	s y l @ s
SØLET	s y l @ t
SØLETE	s y l e t a
SØLETES	s y l e t @ s
SØLETS	s y l E t s
SØLING	s y l I N
SØLT	s W l t
SØLTE	s W l t a
SØLTES	s W l t @ s
SØLTS	s W l t s
SØNN	s W n
SØNNAVÊR	s W n n a v @ R
SØNNAVÊRA	s W n n a v e R A
SØNNAVÊRET	s W n n a v e R @ t
SØNNAVÊRI	s W n n a v e R i
SØR	s y R
SØRE	s y R a
SØREN	s y R @ n
SØRES	s y R @ s
SØRHEIM	s W R h aI m
SØRING	s y R I N
SØRLIG	s W R l I
SØRLIGE	s W R l i g a
SØRLIGES	s W R l i g @ s
SØRLIGS	s W R l I g s
SØRNORSKE	s W R n O R S k a
SØRVOLD	s W R v O l l
SØRØ	s y R y
SØT	s y t
SØTA	s y t A
SØTAS	s y t a s
SØTE	s y t a
SØTEDE	s y t e d a
SØTEN	s y t @ n
SØTENDE	s y t E n n a
SØTENDES	s y t E n n @ s
SØTENE	s y t E n a
SØTENES	s y t e n @ s
SØTENS	s y t @ n s
SØTER	s y t @ R
SØTERS	s y t a S
SØTES	s y t @ s
SØTET	s y t @ t
SØTETE	s y t e t a
SØTETES	s y t e t @ s
SØTETS	s y t E t s
SØTING	s y t I N
SØTT	s W t
SØTTS	s W t s
SØVIG	s y v I
SØVIK	s y v i k
TANKFLÒTANE	t A N k f l u t a n a
TANKFLÒTAR	t A N k f l u t a R
TANKFLÒTE	t A N k f l u t a
TANKFLÒTEN	t A N k f l u t @ n
TANNRÒT	t A n R u t
TANNRÒTA	t A n R u t A
TANNRÒTANE	t A n R u t a n a
TANNRÒTAR	t A n R u t a R
TANNRÒTE	t A n R u t a
TANNRÒTEN	t A n R u t @ n
TANNRÒTET	t A n R u t @ t
TANNRÒTI	t A n R u t i
TEDDYFÔRI	t E d y f u R i
TEODICÉANE	t e u d i k e a n a
TEODICÉAR	t e u d i k e a R
TÊTE-À-TÊTANE	t e t a A g R A v i s t e t a n a
TÊTE-À-TÊTAR	t e t a A g R A v i s t e t a R
TILLÉT	t I l l e t
TILSTØTT	t I l s t W t
TILSTØTTE	t I l s t W t a
TILSTØTTES	t I l s t W t @ s
TILSTØTTS	t I l s t W t s
TIØRENE	t i y R E n a
TIØRENES	t i y R e n @ s
TIØRING	t i y R I N
TIØRINGEN	t i y R I N @ n
TIØRINGENE	t i y R I N E n a
TIØRINGENES	t i y R I N e n @ s
TIØRINGENS	t i y R I N @ n s
TIØRINGER	t i y R I N @ R
TIØRINGERS	t i y R I N a S
TIØRINGS	t i y R I N s
TJØREBAND	s y R e b A n n
TJØREBANDA	s y R e b A n n A
TJØREBANDAS	s y R e b A n n a s
TJØREBANDENE	s y R e b A n n E n a
TJØREBANDENES	s y R e b A n n e n @ s
TJØREBANDET	s y R e b A n n @ t
TJØREBANDETS	s y R e b A n n E t s
TJØREBANDS	s y R e b A n n s
TJØREBLOM	s y R @ b l u m
TJØREBLOMMEN	s y R @ b l O m m @ n
TJØREBLOMMENE	s y R @ b l O m m E n a
TJØREBLOMMENES	s y R @ b l O m m e n @ s
TJØREBLOMMENS	s y R @ b l O m m @ n s
TJØREBLOMMER	s y R @ b l O m m @ R
TJØREBLOMMERS	s y R @ b l O m m a S
TJØREBLOMS	s y R @ b l O m s
TJØREBLOMST	s y R @ b l O m s t
TJØREBLOMSTEN	s y R @ b l O m s t @ n
TJØREBLOMSTENE	s y R @ b l O m s t E n a
TJØREBLOMSTENES	s y R @ b l O m s t e n @ s
TJØREBLOMSTENS	s y R @ b l O m s t @ n s
TJØREBLOMSTER	s y R @ b l O m s t @ R
TJØREBLOMSTERS	s y R @ b l O m s t a S
TJØREBLOMSTS	s y R @ b l O m s t s
TJØREBRE	s y R E b R a
TJØREBREDD	s y R @ b R E d
TJØREBREDDE	s y R @ b R E d a
TJØREBREDDES	s y R @ b R E d @ s
TJØREBREDDS	s y R @ b R E d s
TJØREBREDT	s y R @ b R E d t
TJØREBREDTE	s y R @ b R E d t a
TJØREBREDTES	s y R @ b R E d t @ s
TJØREBREDTS	s y R @ b R E d t s
TJØREBREENDE	s y R @ b R e E n n a
TJØREBREENDES	s y R @ b R e E n n @ s
TJØREBREING	s y R @ b R aI N
TJØREBRENNER	s y R @ b R E n n @ R
TJØREBRENNERE	s y R @ b R E n n e R a
TJØREBRENNEREN	s y R @ b R E n n e R @ n
TJØREBRENNERENS	s y R @ b R E n n e R @ n s
TJØREBRENNERER	s y R @ b R E n n e R @ R
TJØREBRENNERERS	s y R @ b R E n n e R a S
TJØREBRENNERES	s y R @ b R E n n e R @ s
TJØREBRENNERNE	s y R @ b R E n n a R n a
TJØREBRENNERNES	s y R @ b R E n n a R n @ s
TJØREBRENNERS	s y R @ b R E n n a S
TJØREBRER	s y R E b R @ R
TJØREBRES	s y R E b R @ s
TJØREBÅND	s y R e b O n n
TJØREBÅNDA	s y R e b O n n A
TJØREBÅNDAS	s y R e b O n n a s
TJØREBÅNDENE	s y R e b O n n E n a
TJØREBÅNDENES	s y R e b O n n e n @ s
TJØREBÅNDET	s y R e b O n n @ t
TJØREBÅNDETS	s y R e b O n n E t s
TJØREBÅNDS	s y R e b O n n s
TJØREKOST	s y R e k w s t
TJØREKOSTEN	s y R e k w s t @ n
TJØREKOSTENE	s y R e k w s t E n a
TJØREKOSTENES	s y R e k w s t e n @ s
TJØREKOSTENS	s y R e k w s t @ n s
TJØREKOSTER	s y R e k w s t @ R
TJØREKOSTERS	s y R e k w s t a S
TJØREKOSTS	s y R e k w s t s
TJØREPAPP	s y R e p A p
TJØREPAPPEN	s y R e p A p @ n
TJØREPAPPENE	s y R e p A p E n a
TJØREPAPPENES	s y R e p A p e n @ s
TJØREPAPPENS	s y R e p A p @ n s
TJØREPAPPER	s y R e p A p @ R
TJØREPAPPERS	s y R e p A p a S
TJØREPAPPS	s y R e p A p s
TJØRESÅPA	s y R e s o p A
TJØRESÅPAS	s y R e s o p a s
TJØRESÅPE	s y R e s o p a
TJØRESÅPEN	s y R e s o p @ n
TJØRESÅPENE	s y R e s o p E n a
TJØRESÅPENES	s y R e s o p e n @ s
TJØRESÅPENS	s y R e s o p @ n s
TJØRESÅPER	s y R e s o p @ R
TJØRESÅPERS	s y R e s o p a S
TJØRESÅPES	s y R e s o p @ s
TÒLA	t u l A
TÒLE	t u l a
TÒLENE	t u l E n a
TÒLER	t u l @ R
TÒLONE	t u l u n a
TÒLOR	t u l u R
TOMATPURÉANE	t u m A t p u R e a n a
TOMATPURÉAR	t u m A t p u R e a R
TÒN	t u n
TÒNA	t u n A
TÒNANDE	t u n A n n a
TÒNAR	t u n a R
TÒNAS	t u n a s
TÒNAST	t u n A s t
TÒNE	t u n a
TÒNENE	t u n E n a
TÒNER	t u n @ R
TÒNONE	t u n u n a
TÒNOR	t u n u R
TOREVÊR	t u R e v @ R
TOREVÊRA	t u R e v e R A
TOREVÊRET	t u R e v e R @ t
TOREVÊRI	t u R e v e R i
TORSJONSFJØRING	t O R S O n s f j y R I N
TOTENSCHLÄGERANE	t u t @ n S l E g e R a n a
TOTENSCHLÄGERAR	t u t @ n S l E g e R a R
TOØRING	t u y R I N
TOØRINGEN	t u y R I N @ n
TOØRINGENE	t u y R I N E n a
TOØRINGENES	t u y R I N e n @ s
TOØRINGENS	t u y R I N @ n s
TOØRINGER	t u y R I N @ R
TOØRINGERS	t u y R I N a S
TOØRINGS	t u y R I N s
TRAKÉANE	t R a k e a n a
TRAKÉAR	t R a k e a R
TRASÉANE	t R a s e a n a
TRASÉAR	t R a s e a R
TRAUSTVÊR	t R a w s t v @ R
TRAUSTVÊRA	t R a w s t v e R A
TRAUSTVÊRET	t R a w s t v e R @ t
TRAUSTVÊRI	t R a w s t v e R i
TRETJØRE	t R E s y R a
TRETTIÅRSJUBILÉ	t R E t i O R S u b i l e
TRETTIÅRSJUBILÉA	t R E t i O R S u b i l e A
TRETTIÅRSJUBILÉET	t R E t i O R S u b i l e @ t
TRETTIÅRSJUBILÉI	t R E t i O R S u b i l e i
TRILLEBØR	t R I l l e b y R
TRILLEBØRA	t R I l l e b y R A
TRILLEBØRAS	t R I l l e b y R a s
TRILLEBØREN	t R I l l e b y R @ n
TRILLEBØRENE	t R I l l e b y R E n a
TRILLEBØRENES	t R I l l e b y R e n @ s
TRILLEBØRENS	t R I l l e b y R @ n s
TRILLEBØRER	t R I l l e b y R @ R
TRILLEBØRERS	t R I l l e b y R a S
TRILLEBØRS	t R I l l e b W S
TROFÉANE	t R u f e a n a
TROFÉAR	t R u f e a R
TROFÉI	t R u f e i
TROKÉANE	t R u k e a n a
TROKÉAR	t R u k e a R
TROLLVÊR	t R O l v @ R
TROLLVÊRA	t R O l v e R A
TROLLVÊRET	t R O l v e R @ t
TROLLVÊRI	t R O l v e R i
TRÆ	t R E
TRÆDD	t R a d
TRÆDDE	t R a d a
TRÆDDES	t R a d @ s
TRÆDDS	t R a d s
TRÆENDE	t R E E n n a
TRÆENDES	t R E E n n @ s
TRÆING	t R E I N
TRÆL	t R E l
TRÆLEN	t R E l @ n
TRÆLENE	t R E l E n a
TRÆLENES	t R E l e n @ s
TRÆLENS	t R E l @ n s
TRÆLER	t R E l @ R
TRÆLERS	t R E l a S
TRÆLET	t R E l @ t
TRÆLETE	t R E l e t a
TRÆLETES	t R E l e t @ s
TRÆLETS	t R E l E t s
TRÆLS	t R a l s
TRÆR	t R a R
TRÆS	t R E s
TRØ	t R y
TRØA	t R y A
TRØAS	t R y a s
TRØDD	t R W d
TRØDDE	t R W d a
TRØDDES	t R W d @ s
TRØDDS	t R W d s
TRØE	t R y a
TRØEN	t R y @ n
TRØEN	t R y @ n
TRØENDE	t R y E n n a
TRØENDES	t R y E n n @ s
TRØENE	t R y E n a
TRØENES	t R y e n @ s
TRØENS	t R y @ n s
TRØER	t R y @ R
TRØERS	t R y a S
TRØES	t R y @ s
TRØET	t R y @ t
TRØING	t R y I N
TRØKK	t R W k
TRØKKEN	t R W k @ n
TRØKKET	t R W k @ t
TRØR	t R y R
TRØRNE	t R W R n a
TRØRNES	t R W R n @ s
TRØRS	t R W S
TRØS	t R y s
TRØTT	t R W t
TRØTTS	t R W t s
TRÅVÊR	t R o v @ R
TRÅVÊRA	t R o v e R A
TRÅVÊRET	t R o v e R @ t
TRÅVÊRI	t R o v e R i
TUPÉANE	t u p e a n a
TUPÉAR	t u p e a R
TURKEVÊR	t u R k e v @ R
TURKEVÊRA	t u R k e v e R A
TURKEVÊRET	t u R k e v e R @ t
TURKEVÊRI	t u R k e v e R i
TURNÉANE	t u R n e a n a
TURNÉAR	t u R n e a R
TURNIKÉI	t u R n i k e i
TURRFÔR	t u R R f u R
TURRFÔRA	t u R R f u R A
TURRFÔRET	t u R R f u R @ t
TURRFÔRI	t u R R f u R i
TURRÒT	t u R R u t
TURRÒTANE	t u R R u t a n a
TURRÒTAR	t u R R u t a R
TURRÒTE	t u R R u t a
TURRÒTEN	t u R R u t @ n
TURRÒTENT	t u R R u t E n t
TURRÒTI	t u R R u t i
TURRÒTNARE	t u R R O t n a R a
TURRÒTNAST	t u R R O t n A s t
TURRÒTNASTE	t u R R O t n A s t a
TURRÒTNE	t u R R O t n a
TURR-RÒT	t u R R R u t
TURR-RÒTANE	t u R R R u t a n a
TURR-RÒTAR	t u R R R u t a R
TURR-RÒTE	t u R R R u t a
TURR-RÒTEN	t u R R R u t @ n
TURR-RÒTENT	t u R R R u t E n t
TURR-RÒTI	t u R R R u t i
TURR-RÒTNARE	t u R R R O t n a R a
TURR-RÒTNAST	t u R R R O t n A s t
TURR-RÒTNASTE	t u R R R O t n A s t a
TURR-RÒTNE	t u R R R O t n a
TURRVÊR	t u R R v @ R
TURRVÊRA	t u R R v e R A
TURRVÊRET	t u R R v e R @ t
TURRVÊRI	t u R R v e R i
TVANGSFÔRANDE	t v A N s f u R A n n a
TVANGSFÔRAR	t v A N s f u R a R
TVANGSFÔRAST	t v A N s f u R A s t
TYTEBÆRGELÉ	t y t e b a R g e l e
TYTEBÆRGELÉANE	t y t e b a R g e l e a n a
TYTEBÆRGELÉAR	t y t e b a R g e l e a R
TYTEBÆRGELÉEN	t y t e b a R g e l e @ n
TYTTEBÆRGELÉ	t y t e b a R g e l e
TYTTEBÆRGELÉANE	t y t e b a R g e l e a n a
TYTTEBÆRGELÉAR	t y t e b a R g e l e a R
TYTTEBÆRGELÉEN	t y t e b a R g e l e @ n
TÆL	t E l
TÆLS	t a l s
TÆR	t a R
TÆRE	t a R a
TÆRENDE	t a R E n n a
TÆRER	t a R @ R
TÆRES	t a R @ s
TÆRET	t a R @ t
TÆRNE	t a R n a
TÆRNES	t a R n @ s
TÆRS	t a S
TÄTT	t E t
TØ	t y
TØA	t y A
TØAS	t y a s
TØEN	t y @ n
TØENE	t y E n a
TØENES	t y e n @ s
TØENS	t y @ n s
TØER	t y @ R
TØERS	t y a S
TØMMERFLØTER	t W m m a R f l y t @ R
TØMMERFLØTERS	t W m m a R f l y t a S
TØR	t y R
TØRKEVÊR	t W R k e v @ R
TØRKEVÊRA	t W R k e v e R A
TØRKEVÊRET	t W R k e v e R @ t
TØRKEVÊRI	t W R k e v e R i
TØRN	t W R n
TØRNA	t W R n A
TØRNAS	t W R n a s
TØRNE	t W R n a
TØRNEDE	t W R n e d a
TØRNENDE	t W R n E n n a
TØRNENDES	t W R n E n n @ s
TØRNENE	t W R n E n a
TØRNENES	t W R n e n @ s
TØRNER	t W R n @ R
TØRNES	t W R n @ s
TØRNES	t W R n @ s
TØRNET	t W R n @ t
TØRNETE	t W R n e t a
TØRNETES	t W R n e t @ s
TØRNETS	t W R n E t s
TØRNING	t W R n I N
TØRNS	t W R n s
TØRRFÔRI	t W R R f u R i
TØRRÒT	t W R R u t
TØRRÒTANE	t W R R u t a n a
TØRRÒTAR	t W R R u t a R
TØRRÒTE	t W R R u t a
TØRRÒTEN	t W R R u t @ n
TØRRÒTENT	t W R R u t E n t
TØRRÒTI	t W R R u t i
TØRRÒTNARE	t W R R O t n a R a
TØRRÒTNAST	t W R R O t n A s t
TØRRÒTNASTE	t W R R O t n A s t a
TØRRÒTNE	t W R R O t n a
TØRR-RÒT	t W R R R u t
TØRR-RÒTANE	t W R R R u t a n a
TØRR-RÒTAR	t W R R R u t a R
TØRR-RÒTE	t W R R R u t a
TØRR-RÒTEN	t W R R R u t @ n
TØRR-RÒTENT	t W R R R u t E n t
TØRR-RÒTI	t W R R R u t i
TØRR-RÒTNARE	t W R R R O t n a R a
TØRR-RÒTNAST	t W R R R O t n A s t
TØRR-RÒTNASTE	t W R R R O t n A s t a
TØRR-RÒTNE	t W R R R O t n a
TØRRVÊR	t W R R v @ R
TØRRVÊRA	t W R R v e R A
TØRRVÊRET	t W R R v e R @ t
TØRRVÊRI	t W R R v e R i
TØRSTAD	t W R S t a d
TØRT	t W R t
TØRTS	t W R t s
TØRUD	t y R u d
TØS	t y s
TØT	t y t
TØVÊR	t y v @ R
TØVÊRA	t y v e R A
TØVÊRET	t y v e R @ t
TØVÊRI	t y v e R i
TØYRVÊR	t y y R v @ R
TØYRVÊRA	t y y R v e R A
TØYRVÊRET	t y y R v e R @ t
TØYRVÊRI	t y y R v e R i
TØYVÊR	t y y v @ R
TØYVÊRA	t y y v e R A
TØYVÊRET	t y y v e R @ t
TØYVÊRI	t y y v e R i
TÅKEVÊR	t o k e v @ R
TÅKEVÊRA	t o k e v e R A
TÅKEVÊRET	t o k e v e R @ t
TÅKEVÊRI	t o k e v e R i
ULØST	u l W s t
ULØSTE	u l W s t a
ULØSTES	u l W s t @ s
ULØSTS	u l W s t s
UNDERFÔRA	u n n a R f u R A
UNDERFÔRAARE	u n n a R f u R o R a
UNDERFÔRAAST	u n n a R f u R O s t
UNDERFÔRAASTE	u n n a R f u R O s t a
UNDERGJØRENDE	u n n a R j y R E n n a
UNDERGJØRENDES	u n n a R j y R E n n @ s
UNDERSTØTT	u n n a R S t W t
UNDERSTØTTE	u n n a R S t W t a
UNDERSTØTTES	u n n a R S t W t @ s
<UNK>	u N k
UNNLÉT	u n l e t
UNNLÈT	u n l @ t
UNØDIG	u n y d I
UNØDIGE	u n y d i g a
UNØDIGES	u n y d i g @ s
UNØDIGS	u n y d I g s
URFJØR	u R f j y R
URFJØRA	u R f j y R A
URFJØRAS	u R f j y R a s
URFJØREN	u R f j y R @ n
URFJØRENE	u R f j y R E n a
URFJØRENES	u R f j y R e n @ s
URFJØRENS	u R f j y R @ n s
URFJØRS	u R f j W S
URPREMIÉRE	u R p R e m i e R a
URPREMIÉREN	u R p R e m i e R @ n
UTANVÊR	u t A n v @ R
UTANVÊRA	u t A n v e R A
UTANVÊRET	u t A n v e R @ t
UTANVÊRI	u t A n v e R i
UTAVÊR	u t a v @ R
UTAVÊRA	u t a v e R A
UTAVÊRET	u t a v e R @ t
UTAVÊRI	u t a v e R i
UTELÉT	u t e l e t
UTELÈT	u t e l @ t
UTEVÊR	u t e v @ R
UTEVÊRA	u t e v e R A
UTEVÊRET	u t e v e R @ t
UTEVÊRI	u t e v e R i
UTFÔRINGANE	u t f u R I N a n a
UTFÔRINGAR	u t f u R I N a R
UTFÔRINGI	u t f u R I N i
UTFØRING	u t f y R I N
UTFØRINGA	u t f y R I N A
UTFØRINGAS	u t f y R I N a s
UTFØRINGEN	u t f y R I N @ n
UTFØRINGENE	u t f y R I N E n a
UTFØRINGENES	u t f y R I N e n @ s
UTFØRINGENS	u t f y R I N @ n s
UTFØRINGER	u t f y R I N @ R
UTFØRINGERS	u t f y R I N a S
UTFØRINGS	u t f y R I N s
UTSTØTT	u t s t W t
UTSTØTTE	u t s t W t a
UTSTØTTES	u t s t W t @ s
UTSTØTTS	u t s t W t s
UVÊR	u v @ R
UVÊRA	u v e R A
UVÊRET	u v e R @ t
UVÊRI	u v e R i
UVÊRSBOLK	u v a R S b O l k
UVÊRSBOLKANE	u v a R S b O l k a n a
UVÊRSBOLKAR	u v a R S b O l k a R
UVÊRSBOLKEN	u v a R S b O l k @ n
UVÊRSDAG	u v a R S d a g
UVÊRSDAGANE	u v a R S d a g a n a
UVÊRSDAGAR	u v a R S d a g a R
UVÊRSDAGEN	u v a R S d a g @ n
UVÊRSFUGL	u v a R S f u g l
UVÊRSFUGLANE	u v a R S f u g l a n a
UVÊRSFUGLAR	u v a R S f u g l a R
UVÊRSFUGLEN	u v a R S f u g l @ n
UVÊRSKLEDA	u v a R S k l e d A
UVÊRSKLEDE	u v a R S k l e d a
UVÊRSKLEDET	u v a R S k l e d a
UVÊRSKLEDI	u v a R S k l e d i
UVÊRSKRÅKA	u v a R S k R o k A
UVÊRSKRÅKE	u v a R S k R o k a
UVÊRSKRÅKENE	u v a R S k R o k E n a
UVÊRSKRÅKER	u v a R S k R o k @ R
UVÊRSKRÅKONE	u v a R S k R o k u n a
UVÊRSKRÅKOR	u v a R S k R o k u R
UVÊRSNATT	u v a R S n A t
UVÊRSNATTA	u v a R S n A t A
UVÊRSNATTI	u v a R S n A t i
UVÊRSNETTENE	u v a R S n E t E n a
UVÊRSNETTER	u v a R S n E t @ R
UVÊRSPLAGG	u v a R S p l A g
UVÊRSPLAGGA	u v a R S p l A g A
UVÊRSPLAGGET	u v a R S p l A g @ t
UVÊRSPLAGGI	u v a R S p l A g i
UVÊRSRI	u v a R S R i
UVÊRSRIA	u v a R S R i A
UVÊRSRIENE	u v a R S R i E n a
UVÊRSRIER	u v a R S R i @ R
UVÊRSRII	u v a R S R i i
UVÊRSSENTRA	u v a R S s E n t R A
UVÊRSSENTRAI	u v a R S s E n t R A I
UVÊRSSENTRET	u v a R S s E n t R @ t
UVÊRSSENTRUM	u v a R S s E n t R u m
UVÊRSSENTRUMA	u v a R S s E n t R u m A
UVÊRSSENTRUMET	u v a R S s E n t R u m @ t
UVÊRSSENTRUMI	u v a R S s E n t R u m i
UVÊRSSENTRAA	u v a R S s E n t R o
UVÊRSSKY	u v a R S S y
UVÊRSSKYA	u v a R S S y A
UVÊRSSKYENE	u v a R S S y E n a
UVÊRSSKYER	u v a R S S y @ R
UVÊRSSKYI	u v a R S S y i
UVØRA	u v y R A
VAKTTØRN	v A k t W R n
VAKTTØRNENE	v A k t W R n E n a
VAKTTØRNENES	v A k t W R n e n @ s
VAKTTØRNS	v A k t W R n s
VALKOMITÉ	v A l k u m i t e
VALKOMITÉANE	v A l k u m i t e a n a
VALKOMITÉAR	v A l k u m i t e a R
VALKOMITÉEN	v A l k u m i t e @ n
VALNÒTTRE	v A l n O t R a
VALNÒTTREA	v A l n O t R e A
VALNÒTTREET	v A l n O t R e @ t
VALNÒTTREI	v A l n O t R aI
VARIETÉANE	v a R i e t e a n a
VARIETÉAR	v a R i e t e a R
VARIETÉFRAMSYNING	v a R i e t e f R A m s y n I N
VARIETÉFRAMSYNINGA	v a R i e t e f R A m s y n I N A
VARIETÉFRAMSYNINGANE	v a R i e t e f R A m s y n I N a n a
VARIETÉFRAMSYNINGAR	v a R i e t e f R A m s y n I N a R
VARIETÉFRAMSYNINGI	v a R i e t e f R A m s y n I N i
VARIETÉSCENA	v a R i e t e s k e n A
VARIETÉSCENANE	v a R i e t e s k e n a n a
VARIETÉSCENAR	v a R i e t e s k e n a R
VARIETÉSCENE	v a R i e t e s k E n a
VARIETÉSCENEN	v a R i e t e s k e n @ n
VARIETÉSCENENE	v a R i e t e s k e n E n a
VARIETÉSCENER	v a R i e t e s k e n @ R
VARIETÉSCENONE	v a R i e t e s k e n u n a
VARIETÉSCENOR	v a R i e t e s k e n u R
VARIETÉSENA	v a R i e t e s e n A
VARIETÉSENANE	v a R i e t e s e n a n a
VARIETÉSENAR	v a R i e t e s e n a R
VARIETÉSENE	v a R i e t e s E n a
VARIETÉSENEN	v a R i e t e s e n @ n
VARIETÉSENENE	v a R i e t e s e n E n a
VARIETÉSENER	v a R i e t e s e n @ R
VARIETÉSENONE	v a R i e t e s e n u n a
VARIETÉSENOR	v a R i e t e s e n u R
VARIETÉSONGARINNA	v a R i e t e s O N a R I n n A
VARIETÉSONGARINNE	v a R i e t e s O N a R I n n a
VARIETÉSONGARINNENE	v a R i e t e s O N a R I n n E n a
VARIETÉSONGARINNER	v a R i e t e s O N a R I n n @ R
VARIETÉSONGARINNONE	v a R i e t e s O N a R I n n u n a
VARIETÉSONGARINNOR	v a R i e t e s O N a R I n n u R
VARIETÉSTJERNONE	v a R i e t e s s a R n u n a
VARIETÉSTJERNOR	v a R i e t e s s a R n u R
VEDERFÓRS	v e d a R f O S
VEDERFÓRST	v e d a R f O R S t
VEDØ	v e d y
VENTILFJØR	v E n t I l f j y R
VENTILFJØRA	v E n t I l f j y R A
VENTILFJØRAS	v E n t I l f j y R a s
VENTILFJØREN	v E n t I l f j y R @ n
VENTILFJØRENE	v E n t I l f j y R E n a
VENTILFJØRENES	v E n t I l f j y R e n @ s
VENTILFJØRENS	v E n t I l f j y R @ n s
VENTILFJØRER	v E n t I l f j y R @ R
VENTILFJØRERS	v E n t I l f j y R a S
VENTILFJØRS	v E n t I l f j W S
VÊR	v e R
VÊRA	v e R A
VÊRANDE	v e R A n n a
VÊRANE	v e R a n a
VÊRAR	v e R a R
VÊRAS	v e R a s
VÊRAST	v e R A s t
VÊRBALLONG	v a R b A l l O N
VÊRBALLONGANE	v a R b A l l O N a n a
VÊRBALLONGAR	v a R b A l l O N a R
VÊRBALLONGEN	v a R b A l l O N @ n
VÊRBARKA	v a R b A R k A
VÊRBARKAARE	v a R b A R k o R a
VÊRBARKAAST	v a R b A R k O s t
VÊRBARKAASTE	v a R b A R k O s t a
VÊRBITE	v a R b i t a
VÊRBITEN	v a R b i t @ n
VÊRBITI	v a R b i t i
VÊRBITNARE	v a R b I t n a R a
VÊRBITNAST	v a R b I t n A s t
VÊRBITNASTE	v a R b I t n A s t a
VÊRBITNE	v a R b I t n a
VÊRBLINK	v a R b l I N k
VÊRBLINKANE	v a R b l I N k a n a
VÊRBLINKAR	v a R b l I N k a R
VÊRBLINKEN	v a R b l I N k @ n
VÊRBOGANE	v a R b u g a n a
VÊRBOGAR	v a R b u g a R
VÊRBOGE	v a R b u g a
VÊRBOGEN	v a R b u g @ n
VÊRBOK	v a R b u k
VÊRBOKA	v a R b u k A
VÊRBOKI	v a R b u dZ i
VÊRBRAUT	v a R b R a w t
VÊRBRAUTA	v a R b R a w t A
VÊRBRAUTENE	v a R b R a w t E n a
VÊRBRAUTER	v a R b R a w t @ R
VÊRBRAUTI	v a R b R a w t i
VÊRBREST	v a R b R E s t
VÊRBRESTANE	v a R b R @ s t a n a
VÊRBRESTAR	v a R b R @ s t a R
VÊRBRESTEN	v a R b R E s t @ n
VÊRBRESTENE	v a R b R @ s t E n a
VÊRBRESTER	v a R b R E s t @ R
VÊRBRIGDA	v a R b R I g d A
VÊRBRIGDE	v a R b R I g d a
VÊRBRIGDET	v a R b R I g d a
VÊRBRIGDI	v a R b R I g d i
VÊRBYTA	v a R b y t A
VÊRBYTE	v a R b y t a
VÊRBYTET	v a R b y t @ t
VÊRBYTI	v a R b y t i
VÊRBØKENE	v a R b y k E n a
VÊRBØKER	v a R b y k @ R
VERDENSPREMIÉRE	v a R d @ n s p R e m i e R a
VÊRE	v e R a
VÊREN	v e R @ n
VÊRET	v e R @ t
VÊRFAST	v a R f A s t
VÊRFASTARE	v a R f A s t a R a
VÊRFASTAST	v a R f A s t A s t
VÊRFASTASTE	v a R f A s t A s t a
VÊRFASTE	v a R f A s t a
VÊRFORANDRING	v a R f u R A n n R I N
VÊRFORANDRINGA	v a R f u R A n n R I N A
VÊRFORANDRINGANE	v a R f u R A n n R I N a n a
VÊRFORANDRINGAR	v a R f u R A n n R I N a R
VÊRFORANDRINGI	v a R f u R A n n R I N i
VÊRFORHOLD	v a R f O R h O l l
VÊRFORHOLDA	v a R f O R h O l l A
VÊRFORHOLDET	v a R f O R h O l l @ t
VÊRFORHOLDI	v a R f O R h O l l i
VÊRGARD	v a R g A R
VÊRGARDANE	v a R g A R d a n a
VÊRGARDAR	v a R g A R d a R
VÊRGARDEN	v a R g A R d @ n
VÊRGLAS	v a R g l a s
VÊRGLASA	v a R g l a s A
VÊRGLASET	v a R g l a s @ t
VÊRGLASI	v a R g l a s i
VÊRGLIMT	v a R g l I m t
VÊRGLIMTA	v a R g l I m t A
VÊRGLIMTANE	v a R g l I m t a n a
VÊRGLIMTAR	v a R g l I m t a R
VÊRGLIMTEN	v a R g l I m t @ n
VÊRGLIMTET	v a R g l I m t @ t
VÊRGLIMTI	v a R g l I m t i
VÊRGUD	v a R g u d
VÊRGUDANE	v a R g u d a n a
VÊRGUDAR	v a R g u d a R
VÊRGUDEN	v a R g u d @ n
VÊRHANANE	v a R h a n a n a
VÊRHANAR	v a R h a n a R
VÊRHANE	v a R h a n a
VÊRHANEN	v a R h a n @ n
VÊRHARD	v a R h A R
VÊRHARDARE	v a R h A R d a R a
VÊRHARDAST	v a R h A R d A s t
VÊRHARDASTE	v a R h A R d A s t a
VÊRHARDE	v a R h A R d a
VÊRHARDT	v a R h A R d t
VÊRHERDIG	v a R h a R d I
VÊRHERDIGARE	v a R h a R d i g a R a
VÊRHERDIGAST	v a R h a R d i g A s t
VÊRHERDIGASTE	v a R h a R d i g A s t a
VÊRHERDIGE	v a R h a R d i g a
VÊRHERDSLA	v a R h a R d S l A
VÊRHERDSLE	v a R h a R d S l a
VÊRHERDSLENE	v a R h a R d S l E n a
VÊRHERDSLER	v a R h a R d S l @ R
VÊRHERDSLONE	v a R h a R d S l u n a
VÊRHERDSLOR	v a R h a R d S l u R
VÊRHERDUG	v a R h a R d u g
VÊRHERDUGARE	v a R h a R d u g a R a
VÊRHERDUGAST	v a R h a R d u g A s t
VÊRHERDUGASTE	v a R h a R d u g A s t a
VÊRHERDUGE	v a R h a R d u g a
VÊRHOVUD	v a R h u v u d
VÊRHOVUDANE	v a R h u v u d a n a
VÊRHOVUDAR	v a R h u v u d a R
VÊRHOVUDEN	v a R h u v u d @ n
VÊRHÅR	v a R h o R
VÊRHÅRA	v a R h o R A
VÊRHÅRET	v a R h o R @ t
VÊRHÅRI	v a R h o R i
VÊRI	v e R i
VÊRKART	v a R k A R t
VÊRKARTA	v a R k A R t A
VÊRKARTET	v a R k A R t @ t
VÊRKARTI	v a R k A R t i
VÊRKULA	v a R k u l A
VÊRKULE	v a R k u l a
VÊRKULENE	v a R k u l E n a
VÊRKULER	v a R k u l @ R
VÊRKULONE	v a R k u l u n a
VÊRKULOR	v a R k u l u R
VÊRLAG	v a R l a g
VÊRLAGA	v a R l a g A
VÊRLAGET	v a R l a g @ t
VÊRLAGI	v a R l a j i
VÊRLAM	v a R l a m
VÊRLAMMA	v a R l A m m A
VÊRLAMMET	v a R l A m m @ t
VÊRLAMMI	v a R l A m m i
VÊRLJOS	v a R j u s
VÊRLJOSA	v a R j u s A
VÊRLJOSET	v a R j u s @ t
VÊRLJOSI	v a R j u s i
VÊRLYS	v a R l y s
VÊRLYSA	v a R l y s A
VÊRLYSE	v a R l y s a
VÊRLYSET	v a R l y s @ t
VÊRLYSI	v a R l y s i
VÊRMANN	v a R m A n
VÊRMANNEN	v a R m A n n @ n
VÊRMELDING	v a R m @ l l I N
VÊRMELDINGA	v a R m @ l l I N A
VÊRMELDINGANE	v a R m @ l l I N a n a
VÊRMELDINGAR	v a R m @ l l I N a R
VÊRMELDINGI	v a R m @ l l I N i
VÊRMENN	v a R m E n
VÊRMENNENE	v a R m @ n n E n a
VÊRMENNER	v a R m E n n @ R
VÊRMERKA	v a R m a R k A
VÊRMERKE	v a R m a R k a
VÊRMERKET	v a R m a R k @ t
VÊRMERKI	v a R m a R dZ i
VÊROMSLAG	v e R O m S l a g
VÊROMSLAGA	v e R O m S l a g A
VÊROMSLAGET	v e R O m S l a g @ t
VÊROMSLAGI	v e R O m S l a j i
VÊRSATELLITT	v a R S a t E l l I t
VÊRSATELLITTANE	v a R S a t E l l I t a n a
VÊRSATELLITTAR	v a R S a t E l l I t a R
VÊRSATELLITTEN	v a R S a t E l l I t @ n
VÊRSITUASJON	v a R S i t u A S u n
VÊRSITUASJONANE	v a R S i t u A S u n a n a
VÊRSITUASJONAR	v a R S i t u A S u n a R
VÊRSITUASJONEN	v a R S i t u A S u n @ n
VÊRSJUK	v a R S u k
VÊRSJUKARE	v a R S u k a R a
VÊRSJUKAST	v a R S u k A s t
VÊRSJUKASTE	v a R S u k A s t a
VÊRSJUKE	v a R S u k a
VÊRSJUKT	v a R S u k t
VÊRSKIFTA	v a R S I f t A
VÊRSKIFTE	v a R S I f t a
VÊRSKIFTET	v a R S I f t @ t
VÊRSKIFTI	v a R S I f t i
VÊRSKIP	v a R S i p
VÊRSKIPA	v a R S i p A
VÊRSKIPET	v a R S i p @ t
VÊRSKIPI	v a R S i p i
VÊRSLITE	v a R S l i t a
VÊRSLITEN	v a R S l i t @ n
VÊRSLITI	v a R S l i t i
VÊRSLITNARE	v a R S l I t n a R a
VÊRSLITNAST	v a R S l I t n A s t
VÊRSLITNASTE	v a R S l I t n A s t a
VÊRSLITNE	v a R S l I t n a
VÊRSOL	v a R S u l
VÊRSOLA	v a R S u l A
VÊRSOLENE	v a R S u l E n a
VÊRSOLER	v a R S u l @ R
VÊRSOLI	v a R S u l i
VÊRSTODA	v a R S t u d A
VÊRSTODE	v a R S t u d a
VÊRSTODENE	v a R S t u d E n a
VÊRSTODER	v a R S t u d @ R
VÊRSTODONE	v a R S t u d u n a
VÊRSTODOR	v a R S t u d u R
VÊRSTØDA	v a R S t y d A
VÊRSTØDE	v a R S t y d a
VÊRSTØDET	v a R S t y d a
VÊRSTØDI	v a R S t y d i
VÊRTENEST	v a R t e n E s t
VÊRTENESTA	v a R t e n E s t A
VÊRTENESTE	v a R t e n E s t a
VÊRTENESTENE	v a R t e n E s t E n a
VÊRTENESTER	v a R t e n E s t @ R
VÊRTENESTI	v a R t e n E s t i
VÊRTENESTONE	v a R t e n E s t u n a
VÊRTENESTOR	v a R t e n E s t u R
VÊRTILHØVA	v a R t I l h y v A
VÊRTILHØVE	v a R t I l h y v a
VÊRTILHØVET	v a R t I l h y v @ t
VÊRTILHØVI	v a R t I l h y v i
VÊRTILSTAND	v a R t I l s t A n n
VÊRTILSTANDANE	v a R t I l s t A n n a n a
VÊRTILSTANDAR	v a R t I l s t A n n a R
VÊRTILSTANDEN	v a R t I l s t A n n @ n
VÊRUTSIKT	v e R u t s I k t
VÊRUTSIKTA	v e R u t s I k t A
VÊRUTSIKTENE	v e R u t s I k t E n a
VÊRUTSIKTER	v e R u t s I k t @ R
VÊRUTSIKTI	v e R u t s I k t i
VÊRVARSEL	v a R v A R S @ l
VÊRVARSELET	v a R v A R S e l @ t
VÊRVARSLA	v a R v A R S l A
VÊRVARSLET	v a R v A R S l @ t
VÊRVARSLI	v a R v A R S l i
VÊRVARSLING	v a R v A R S l I N
VÊRVARSLINGA	v a R v A R S l I N A
VÊRVARSLINGANE	v a R v A R S l I N a n a
VÊRVARSLINGAR	v a R v A R S l I N a R
VÊRVARSLINGI	v a R v A R S l I N i
VÊRVARSLINGSTENEST	v a R v A R S l I N s t e n E s t
VÊRVARSLINGSTENESTA	v a R v A R S l I N s t e n E s t A
VÊRVARSLINGSTENESTE	v a R v A R S l I N s t e n E s t a
VÊRVARSLINGSTENESTENE	v a R v A R S l I N s t e n E s t E n a
VÊRVARSLINGSTENESTER	v a R v A R S l I N s t e n E s t @ R
VÊRVARSLINGSTENESTI	v a R v A R S l I N s t e n E s t i
VÊRVARSLINGSTENESTONE	v a R v A R S l I N s t e n E s t u n a
VÊRVARSLINGSTENESTOR	v a R v A R S l I N s t e n E s t u R
VÊRÅTTA	v e R O t A
VÊRÅTTE	v e R O t a
VÊRÅTTENE	v e R O t E n a
VÊRÅTTER	v e R O t @ R
VÊRÅTTONE	v e R O t u n a
VÊRÅTTOR	v e R O t u R
VESTAVÊR	v E s t a v @ R
VESTAVÊRA	v E s t a v e R A
VESTAVÊRET	v E s t a v e R @ t
VESTAVÊRI	v E s t a v e R i
VESTEFÔRI	v E s t e f u R i
VESTLANDSVÊR	v E s t l A n n s v @ R
VESTLANDSVÊRA	v E s t l A n n s v e R A
VESTLANDSVÊRET	v E s t l A n n s v e R @ t
VESTLANDSVÊRI	v E s t l A n n s v e R i
VILJESVÊR	v I j E s v @ R
VILJESVÊRA	v I j @ s v e R A
VILJESVÊRET	v I j @ s v e R @ t
VILJESVÊRI	v I j @ s v e R i
VILJEVÊR	v I j e v @ R
VILJEVÊRA	v I j e v e R A
VILJEVÊRET	v I j e v e R @ t
VILJEVÊRI	v I j e v e R i
VINTERFÔRANDE	v I n t a R f u R A n n a
VINTERFÔRAR	v I n t a R f u R a R
VINTERFÔRAST	v I n t a R f u R A s t
VINTERFÔRE	v I n t a R f u R a
VINTERFÔRI	v I n t a R f u R i
VINTERFÔRINGANE	v I n t a R f u R I N a n a
VINTERFÔRINGAR	v I n t a R f u R I N a R
VINTERFÔRINGI	v I n t a R f u R I N i
VINTERVÊR	v I n t a R v @ R
VINTERVÊRA	v I n t a R v e R A
VINTERVÊRET	v I n t a R v e R @ t
VINTERVÊRI	v I n t a R v e R i
VIS-Á-VIS	v i s A A k u t v i s
VISKELÊR	v I s k e l @ R
VISKELÊRA	v I s k e l e R A
VISKELÊRET	v I s k e l e R @ t
VISKELÊRI	v I s k e l e R i
VÒK	v u k
VÒKA	v u k A
VÒKANDE	v u k A n n a
VÒKAR	v u k a R
VÒKAS	v u k a s
VÒKAST	v u k A s t
VÒKE	v u k a
VÒKEELD	v u k e E l l
VÒKEELDANE	v u k e E l l a n a
VÒKEELDAR	v u k e E l l a R
VÒKEELDEN	v u k e E l l @ n
VÒKENATT	v u k e n A t
VÒKENATTA	v u k e n A t A
VÒKENATTI	v u k e n A t i
VÒKENE	v u k E n a
VÒKENETTENE	v u k e n E t E n a
VÒKENETTER	v u k e n E t @ R
VÒKER	v u k @ R
VÒKI	v u dZ i
VÒKONE	v u k u n a
VÒKOR	v u k u R
VONDVÊR	v w n n v @ R
VONDVÊRA	v w n n v e R A
VONDVÊRET	v w n n v e R @ t
VONDVÊRI	v w n n v e R i
VÓR	v u R
VÒR	v u R
VÓRANE	v u R a n a
VÒRANE	v u R a n a
VÓRAR	v u R a R
VÒRAR	v u R a R
VÓREN	v u R @ n
VÒREN	v u R @ n
VÆPNA	v a p n A
VÆPNET	v a p n @ t
VÆR	v a R
VÆRA	v a R A
VÆRAS	v a R a s
VÆRE	v a R a
VÆREN	v a R @ n
VÆRENDE	v a R E n n a
VÆRENDES	v a R E n n @ s
VÆRENE	v a R E n a
VÆRENES	v a R e n @ s
VÆRENS	v a R @ n s
VÆRER	v a R @ R
VÆRERS	v a R a S
VÆRES	v a R @ s
VÆRET	v a R @ t
VÆRETE	v a R e t a
VÆRETES	v a R e t @ s
VÆRETS	v a R E t s
VÆRING	v a R I N
VÆRS	v a S
VÆRT	v a R t
VÆRTEGN	v a R t E N n
VÆRVEIEN	v a R v aI @ n
VÆT	v E t
VÆTE	v E t a
VÆTERE	v E t e R a
VÆTERES	v E t e R @ s
VÆTES	v E t @ s
VÆTT	v a t
VÆTTS	v a t s
VØL	v y l
VØLA	v y l A
VØLAS	v y l a s
VØLE	v y l a
VØLENDE	v y l E n n a
VØLENDES	v y l E n n @ s
VØLER	v y l @ R
VØLES	v y l @ s
VØLING	v y l I N
VØLT	v W l t
VØLTE	v W l t a
VØLTES	v W l t @ s
VØLTS	v W l t s
VØR	v y R
VØRE	v y R a
VØRENDE	v y R E n n a
VØRENDES	v y R E n n @ s
VØRER	v y R @ R
VØRES	v y R @ s
VØRING	v y R I N
VØRT	v W R t
VÅR	v o R
VÅRD	v O R
VÅRVÊR	v O R v @ R
VÅRVÊRA	v O R v e R A
VÅRVÊRET	v O R v e R @ t
VÅRVÊRI	v O R v e R i
VÅTFÔRI	v O t f u R i
VÅTVÊR	v O t v @ R
VÅTVÊRA	v O t v e R A
VÅTVÊRET	v O t v e R @ t
VÅTVÊRI	v O t v e R i
WÖRNER	v W R n @ R
YNSKEVÊR	y n s k e v @ R
YNSKEVÊRA	y n s k e v e R A
YNSKEVÊRET	y n s k e v e R @ t
YNSKEVÊRI	y n s k e v e R i
YNSKJEVÊR	y n S e v @ R
YNSKJEVÊRA	y n S e v e R A
YNSKJEVÊRET	y n S e v e R @ t
YNSKJEVÊRI	y n S e v e R i
YRKESKARRIÉRE	y R k @ s k A R R i e R a
Æ	E
Æ	E
Æ-EN	E e n
ÆEN	E @ n
Æ-ENE	E e n a
ÆENE	E E n a
Æ-ENES	E e n @ s
ÆENES	E e n @ s
Æ-ENS	E E n s
ÆENS	E @ n s
Æ-ER	E E R
ÆER	E @ R
Æ-ERS	E a S
ÆERS	E a S
ÆNES	E n @ s
ÆR	a R
ÆRA	a R A
ÆRAS	a R a s
ÆRE	a R a
ÆREDE	a R e d a
ÆREN	a R @ n
ÆRENE	a R E n a
ÆRENES	a R e n @ s
ÆRENS	a R @ n s
ÆRER	a R @ R
ÆRERS	a R a S
ÆRES	a R @ s
ÆRET	a R @ t
ÆRETE	a R e t a
ÆRETES	a R e t @ s
ÆRETS	a R E t s
ÆRFUGLVEIEN	a R f u g l v aI @ n
ÆRING	a R I N
ÆRLIG	a R l I
ÆRLIGE	a R l i g a
ÆRLIGES	a R l i g @ s
ÆRLIGS	a R l I g s
ÆRS	a S
ÆRVIK	a R v i k
ÆS	E s
ÆS	E s
ÆSENE	E s E n a
ÆSENES	E s e n @ s
ÆSER	E s @ R
ÆSERS	E s a S
ÆSET	E s @ t
ÆSETS	E s E t s
ÆTT	a t
ÆTTE	a t a
ÆTTENDE	a t E n n a
ÆTTER	a t @ R
ÆTTERS	a t a S
ÆTTES	a t @ s
ÆTTING	a t I N
ÆTTINGEN	a t I N @ n
ÆTTINGENE	a t I N E n a
ÆTTINGENES	a t I N e n @ s
ÆTTINGENS	a t I N @ n s
ÆTTINGER	a t I N @ R
ÆTTINGERS	a t I N a S
ÆTTINGS	a t I N s
ÆTTS	a t s
Ø	y
Ø	y
ØBERG	y b a R g
ØBY	y b y
ØDEGÅRD	y d e g O R
ØDEGÅRDEN	y d e g O R d @ n
ØDEGÅRDS	y d e g O R d s
ØDEMARK	y d e m A R k
Ø-EN	y e n
ØEN	y @ n
ØEN	y @ n
Ø-ENE	y e n a
ØENE	y E n a
Ø-ENES	y e n @ s
ØENES	y e n @ s
Ø-ENS	y E n s
ØENS	y @ n s
Ø-ER	y E R
ØER	y @ R
Ø-ERS	y a S
ØERS	y a S
ØK	y k
ØKA	y k A
ØKAS	y k a s
ØKE	y k a
ØKENDE	y k E n n a
ØKENDES	y k E n n @ s
ØKENE	y k E n a
ØKENES	y k e n @ s
ØKER	y k @ R
ØKEREN	y k e R @ n
ØKES	y k @ s
ØKET	y k @ t
ØKETS	y k E t s
ØKING	y dZ I N
ØKOKRIM	y k O k R i m
ØKOKRIMS	y k O k R I m s
ØKS	W k s
ØKSEKOMITÉ	W k s e k u m i t e
ØKSEKOMITÉANE	W k s e k u m i t e a n a
ØKSEKOMITÉAR	W k s e k u m i t e a R
ØKSEKOMITÉEN	W k s e k u m i t e @ n
ØKT	W k t
ØKTE	W k t a
ØKTES	W k t @ s
ØKTS	W k t s
ØL	y l
ØLA	y l A
ÖLAND	y l A n n
ØLANDSK	y l A n n s k
ØLANDSKE	y l A n n s k a
ØLANDSKES	y l A n n s k @ s
ØLANDSKS	y l A n n s k s
ØLAS	y l a s
ØLE	y l a
ØLEN	y l @ n
ØLEN	y l @ n
ØLENDE	y l E n n a
ØLENDES	y l E n n @ s
ØLENDING	y l @ n n I N
ØLENDINGEN	y l @ n n I N @ n
ØLENDINGENE	y l @ n n I N E n a
ØLENDINGENES	y l @ n n I N e n @ s
ØLENDINGENS	y l @ n n I N @ n s
ØLENDINGER	y l @ n n I N @ R
ØLENDINGERS	y l @ n n I N a S
ØLENDINGS	y l @ n n I N s
ØLENE	y l E n a
ØLENES	y l e n @ s
ØLENS	y l @ n s
ØLER	y l @ R
ØLES	y l @ s
ØLET	y l @ t
ØLETE	y l e t a
ØLETES	y l e t @ s
ØLETS	y l E t s
ØLING	y l I N
ØLS	W l s
ØLSTAD	W l s t a d
ØLTE	W l t a
ØMER	y m @ R
ØNSKEVÊR	W n s k e v @ R
ØNSKEVÊRA	W n s k e v e R A
ØNSKEVÊRET	W n s k e v e R @ t
ØNSKEVÊRI	W n s k e v e R i
ØNSKJEVÊR	W n S e v @ R
ØNSKJEVÊRA	W n S e v e R A
ØNSKJEVÊRET	W n S e v e R @ t
ØNSKJEVÊRI	W n S e v e R i
ØR	y R
ØRA	y R A
ØRA	y R A
ØRAS	y R a s
ØRE	y R a
ØREBETENNELSE	y R e b e t @ n n E l s a
ØREBETENNELSEN	y R e b e t @ n n E l s @ n
ØREBETENNELSENE	y R e b e t @ n n E l s E n a
ØREBETENNELSENES	y R e b e t @ n n E l s e n @ s
ØREBETENNELSENS	y R e b e t @ n n E l s @ n s
ØREBETENNELSER	y R e b e t @ n n E l s @ R
ØREBETENNELSERS	y R e b e t @ n n E l s a S
ØREBETENNELSES	y R e b e t @ n n E l s @ s
ØREBLAD	y R @ b l a d
ØREBLADA	y R @ b l a d A
ØREBLADAS	y R @ b l a d a s
ØREBLADENE	y R @ b l a d E n a
ØREBLADENES	y R @ b l a d e n @ s
ØREBLADER	y R @ b l a d @ R
ØREBLADERS	y R @ b l a d a S
ØREBLADET	y R @ b l a d a
ØREBLADETS	y R @ b l a d E t s
ØREBLADS	y R @ b l A d s
ØREDE	y R e d a
ØREDES	y R e d @ s
ØREGANG	y R e g A N
ØREGANGEN	y R e g A N @ n
ØREGANGENE	y R e g A N E n a
ØREGANGENES	y R e g A N e n @ s
ØREGANGENS	y R e g A N @ n s
ØREGANGER	y R e g A N @ R
ØREGANGERS	y R e g A N a S
ØREGANGS	y R e g A N s
ØRELØS	y R e l y s
ØREN	y R @ n
ØREN	y R @ n
ØRENDE	y R E n n a
ØRENDES	y R E n n @ s
ØRENE	y R E n a
ØRENES	y R e n @ s
ØRENS	y R @ n s
ØRER	y R @ R
ØRERS	y R a S
ØRES	y R @ s
ØRET	y R @ t
ØRETE	y R e t a
ØRETES	y R e t @ s
ØRETS	y R E t s
-ØRING	y R I N
ØRING	y R I N
ØRINGEN	y R I N @ n
-ØRINGEN	y R I N @ n
ØRINGEN	y R I N @ n
-ØRINGENE	y R I N E n a
ØRINGENE	y R I N E n a
-ØRINGENES	y R I N e n @ s
ØRINGENES	y R I N e n @ s
-ØRINGENS	y R I N @ n s
ØRINGENS	y R I N @ n s
-ØRINGER	y R I N @ R
ØRINGER	y R I N @ R
-ØRINGERS	y R I N a S
ØRINGERS	y R I N a S
-ØRINGS	y R I N s
ØRINGS	y R I N s
ØRKEN	W R k @ n
ØRLAND	W R l A n n
ØRN	W R n
ØRNES	W R n @ s
ØRNS	W R n s
ØRNSKØLDSVIK	W R n s k W l l s v i k
ØRS	W S
ØRSTA	W R S t A
ØRSTAD	W R S t a d
ØRVIK	W R v i k
ØRÅSEN	y R o s @ n
ØS	y s
ØS	y s
ØS'	y s
ØSA	y s A
ØSAS	y s a s
ØSE	y s a
ØSEN	y s @ n
ØSENE	y s E n a
ØSENES	y s e n @ s
ØSENS	y s @ n s
ØSER	y s @ R
ØSERS	y s a S
ØSES	y s @ s
ØSET	y s @ t
ØSETS	y s E t s
ØSING	y s I N
ØSTAVINDEN	W s t a v I n n @ n
ØSTEN	W s t @ n
ØSTERUD	W s t e R u d
ØSTFOLD	W s t f O l l
ØSTMARK	W s t m A R k
ØSTMARKA	W s t m A R k A
ØSTSIDA	W s t s i d A
ØSTSIDEN	W s t s i d @ n
ØVE	y v a
ØVER	y v @ R
ØVERÅS	y v e R o s
ØVES	y v @ s
ØVRE	W v R a
ØY	y y
ØYA	y y A
ØYDEGARD	y y d e g A R
ØYE	y y a
ØYEN	y y @ n
ØYER	y y @ R
ØYGARD	y y g A R
ØYGARDEN	y y g A R d @ n
ØYKEFÔR	y y k e f u R
ØYKEFÔRA	y y k e f u R A
ØYKEFÔRET	y y k e f u R @ t
ØYKEFÔRI	y y k e f u R i
ØYNES	y y n @ s
ØYRANE	y y R a n a
ØYRE	y y R a
ØYVIND	y y v I n n
Å	o
ÅKE	o k a
ÅKER	o k @ R
ÅKRE	O k R a
ÅL	o l
ÅLEN	o l @ n
ÅM	o m
ÅMOT	o m u t
ÅRE	o R a
ÅRELÉT	o R e l e t
ÅRELÈT	o R e l @ t
ÅRNES	O R n @ s
ÅRSKOG	O R S k u g
ÅS	o s
ÅSA	o s A
ÅSANE	o s a n a
ÅSE	o s a
ÅSEN	o s @ n
ÅSRYGGEN	O s R y g @ n
ÅSSIDA	O s s i d A
ÅSSIDEN	O s s i d @ n
ÅSSTUBBEN	O s s t u b @ n
ÅSTE	O s t a
ÅTTIÅRSJUBILÉ	O t i O R S u b i l e
ÅTTIÅRSJUBILÉA	O t i O R S u b i l e A
ÅTTIÅRSJUBILÉET	O t i O R S u b i l e @ t
ÅTTIÅRSJUBILÉI	O t i O R S u b i l e i
ÅTTRINGEN	O t R I N @ n
